名词(中文)	名词(英文)	解释(中文)	解释(英文)
叶脉	Nerve	叶的明显而简单脉或肋。	A prominent, simple vein or rib of a leaf. See illustration for midvein.
叶柄	Petiole	叶的柄。	A leaf stalk.
小叶柄	Petiolule	复叶中小叶的叶柄。	The stalk of a leaflet of a compound leaf.
羽片	Pinna (pl. Pinnae)	羽状复叶的一回羽状小叶。见小叶的插图。	one of the primary divisions or leaflets of a pinnate leaf. See illustration for leaflet.
小羽片	Pinnule	二回或二回以上羽状复叶的末级羽片。	The pinnate division of a pinna in a bipinnately compound leaf, or the ultimate divisions of a leaf which is more than twice pinnately compound.
叶轴	Rachis	复叶的主轴。	The main axis of a compound leaf.
叶轴	Rhachis	复叶的主轴。	The main axis of a compound leaf.
肋	Rib	叶片上主要的纵脉。	A main longitudinal vein in a leaf.
裂片	Segment	叶的裂片。	A section or division of a leaf.
凹缺	Sinus	叶两裂片之间的缺裂、凹陷。	The cleft, depression, or recess. Between two lobes of a leaf.
托叶	Stipule	某些叶柄基部成对的叶状附属物。	One of a pair of leaf-like appendages found at the base of the petiole in some leaves.
卷须	Tendril	柔弱并具缠绕性器官，用以支撑物攀缘生长。	A slender, twining organ used to grasp support form climbing.
齿	Tooth	边缘上的小裂片或尖。	Any small lobe or point along a margin.
脉	Vein	维管束，通常外形可见，如叶中。	A vascular bundle, usually visible externally, as in leaves.
细脉	Veinlet	小的脉。	A small vein.
平卧的	Prostrate	平铺在地面上。	Lying flat on the ground.
具翅茎的	Pterocaulous	茎具翅。	With winged stems.
垫状的	Pulvinate	枕状或垫状。	Cushion-like or mat-like.
垫状的	Pulviniform	枕状或垫状。	Cushion-like or mat-like.
四棱的	Quadrangular	具四个棱角。	Four-angled.
四棱的	Quadrangulate	具四个棱角。	Four-angled.
枝状的	Ramiform	枝条状的；分枝的。	Branchlike in form; branched.
多枝的	Ramose	具许多分枝的；分枝。	With many branches; branching.
多枝的	Ramous	具许多分枝的；分枝。	With many branches; branching.
多小枝的	Ramulose	具许多分枝的；分枝。	With many branches; branching.
拱垂的	Reclining	向下弯曲，靠着某物并由其支撑。	Bending or curving downward. Lying upon something and being supported by it.
横卧的	Recumbent	依靠或躺在地面；平卧的。	Leaning or resting on the ground; prostrate.
匍匐（生根）的	Repent	平卧的；匍匐的。	Prostrate; creeping.
根状茎的	Rhizomatous	具根状茎。	With rhizomes.
莲座状的	Rosulate	具有莲座状排列的叶，茎干极短或无。	With the leaves arranged in basal rosettes, the stem very short or lacking .
多头的	Multicipital	具有多个头，高度分枝的茎基。	With many heads, as in a highly branched caudex.
具节的	Nodiferous	具节。	With nodes.
裸茎的	Nudicaul	无叶的茎。	With leafless stem.
直枝的	Orthocladous	具直立的枝条。	With straight branches.
直生的	Orthotropic	具有近似或表现出直立生长的习性。	Of, pertaining to, or exhibiting an essentially vertical growth habit.
粗枝的	Pachycladous	具粗壮枝条。	With thick branches.
多头的	Pluricipital	具有多个头，高度分枝的茎基。	With many heads, as in a highly branched caudex.
平卧的	Procumbent	茎沿地面上生长，但在节外不生根。	Lying or trailing on the ground, but not rooting at the nodes.
角质层	Cuticle	茎表面的蜡质层。	The waxy layer on the surface of a stem.
上胚轴	Epicotyl	6子叶着生处以上的胚轴部分。	That portion of the embryonic stem above the cotyledons.
表皮	Epidermis	茎上最外面的细胞层。	The outermost cellular layer of a stem.
心材	Heartwood	木本茎干最内的颜色通常较深的木材。	The innermost, usually somewhat darker wood of a woody stem.
下胚轴	Hypocotyl	子叶着生处以下的胚轴部分。	That portion of the embryonic stem below the cotyledons.
节间	Internode	茎上两个节之间的部分。	The portion of a stem between two nodes.
节、关节	Joint	茎上着生叶或枝的部位；节，尤见于禾草本茎。	The section of a stem from which a leaf or branch arises; a node, especially on a grass stem.
叶痕	Leaf scar	叶脱落后留在枝上的痕迹。	The scar remaining on a twig after a leaf falls.
皮孔	Lenticel	幼茎表面略隆起的、木栓化的、凸镜状的结构。	A slightly raised, somewhat corky, often lens-shaped area on the surface of a young stem.
分生组织	Meristem	苗端生长点未分化的具有活跃分裂能力的组织。	Undifferentiated, actively dividing tissues at the growing tip of a shoot.
节	Node	茎上叶和枝的发生部位。	The position on the stem where leaves or branches originate.
韧皮部	Phloem	维管植物传输营养物质的组织；	The food conducting tissue of vascular plants; bark.
髓	Pith	某些茎和根中央的海绵状薄壁组织。	The spongy, parenchymatous central tissue in some stems and roots.
皮刺	Prickle	表皮或树皮上小而尖的突起。	A small , sharp outgrowth of the epidermis or bark.
边材	Sapwood	木本茎中新产生的颜色通常较淡的木材，具有输导水分的功能；边材。	The outer, newer, usually somewhat lighter, wood of woody stem; the wood that is actively transporting water; alburnum.
中柱	Stele	茎的初生维管结构，包括维管组织和维管组织以内的所有组织。	The primary vascular structure of a stem, including the vascular tissues and all tissues internal to the vascular tissues.
树干	Trunk	树的分枝以下的主茎。	The main stem of a tree below the branches.
小枝	Twig	树上的小枝条。	A small shoot or branch from a tree.
鳞茎	Bulb	具有增厚肉质鳞片的地下芽，如洋葱。	An underground bud with thickened fleshy scales, as in the onion.
珠芽	Bulbel	从鳞茎基部生出的小鳞茎。	A small bulb arising form the base of a larger bulb.
珠芽	Bulbil	小的鳞茎。	A small bulb.
小鳞茎	Bulblet	小的鳞茎。	A small bulb.
斜方形的	Rhomboidal	近菱形,侧面为钝角的四边形。	Quadrangular, nearly rhombic, with obtuse lateral angles.
圆形的	Rotund	轮廓呈圆形。	Round or rounded in outline.
箭头形的	Sagittate	形似箭头，基部裂片向下（对比hastate）。	Arrowhead-shaped, with the basal lobes directed downward. (compare hastate)
匙形的	Spathulate	形似勺，先端圆形向基部变细。	Like a spatula in shape, with a rounded blade above gradually tapering to the base.
匙形的	Spatulate	形似勺，先端圆形向基部变细。	Like a spatula in shape, with a rounded blade above gradually tapering to the base.
钻形的	Subulate	形状如锥。	Awl-shaped.
两侧相等的	Aequilateral	两边相等，相对于偏斜的。	Equal-sided, as opposed to oblique.
渐狭的	Attenuate	向基部逐渐变窄。	Tapering gradually to a narrow base.
耳形的	Auriculate	具有耳状的附属物。	With ear-shaped appendages.
心形的	Cordate	心形，基部内凹。	Heart-shaped, with the notch at the base.
楔形的	Cuneate	形状如楔，三角锥形且基部渐尖。	Wedge-shaped, triangular and tapering to a point at the base.
耳形的	Eared	具有耳状的附属物。	With ear-shaped appendages.
戟形的	Halberd-shaped	形似箭头，基部裂片向外而非向下；戟形（对比sagittate）。	Arrowhead-shaped, but with the basal lobes turned outward rather than downward; halberd-shaped. (compare sagittate)
戟形的	Hastate	形似箭头，基部裂片向外而非向下；戟形（对比sagittate）。	Arrowhead-shaped, but with the basal lobes turned outward rather than downward; halberd-shaped. (compare sagittate)
不等侧的	Inequilateral	具不相等的边，斜的。	With unequal side; slanting.
偏斜的	Oblique	具不相等的边，斜的。	With unequal side; slanting.
圆形的	Rounded	基部圆形。	With a rounded base.
箭头形的	Sagittate	形似箭头，基部裂片向下（对应hastate）。	Arrowhead-shaped, with the basal lobes directed downward.(compare hastate)
截形的	Truncate	基部方形，刀切状。	With the base squared at the end as if cut off.
突然的	Abrupt	骤然终止。	Terminating suddenly.
渐尖的	Acuminate	叶顶尖锐，叶尖两侧叶缘内凹。	Gradually tapering to a sharp point and forming concave sides along the tip.
急尖的	Acute	叶顶尖锐，叶尖两侧叶缘近直。	Tapering to a pointed apex with more or less straight sides.
具细尖的	Apiculate	叶先端骤然终止于细尖。	Ending abruptly in small, slender point.
具芒的	Aristate	顶尖具芒或刚毛。	Bearing an awn or bristle at the tip.
具小芒的	Aristulate	顶尖具芒或刚毛。	Bearing a m minute awn or bristle at the tip.
尾状的	Caudate	具有尾状的附属物。	With a tail-like appendage.
卷须状的	Cirrhous	具有卷须。	With a cirrus (tendril).
有卷须的	Cirrose	具有卷须。	With a cirrus (tendril).
骤尖的	Cuspidate	先端短而急尖（尖突）。	Tipped with a short, sharp, abrupt point (cusp).
微缺的	Emarginate	先端略内凹。	With a notch at the apex.
被丛卷毛的	Floccose	具有成丛的长软而缠结的毛。	Bearing tufts of long, soft, tangled hairs.
被短丛卷毛的	Flocculent	具有成丛的细小绵状毛；被丛卷毛的。	Bearing tufts of very fine woolly hairs; floccose.
具沟的	Fluted	具沟或槽的。	With furrow or grooves.
具孔穴的	Foveate	具孔穴；具凹坑的。	With foveae; pitted.
①有小孔穴的②蜂窝状的	Foveolate	具小穴；具小凹坑。	With foveolae; minutely pitted.
具流苏的	Fringed	沿边缘具毛或刚毛。	With hairs or bristles along the margin.
软鳞片状的	Furfuraceous	皮屑状的；糠秕状的；薄片状的。	Scurfy; branlike; flaky.
脱毛的	Glabrate	变光滑，几近无毛的。	Becoming glabrous; almost glabrous.
变无毛的	Glabrescent	变光滑，几近无毛的。	Becoming glabrous; almost glabrous.
①光滑的②无毛的	Glabrous	光滑的；无毛的。	Smooth; hairless.
具腺的	Glandular	具有腺体。	Bearing glands.
带白霜的	Glaucescent	微具白霜；呈苍白色。	Somewhat glaucous; becoming glaucous.
有白霜的	Glaucous	被覆白色或兰色的腊质粉霜层，如李子的表面。	Covered with a whitish or bluish waxy coating (bloom), as on the surface of a plum.
具倒刺的	Glochidiate	顶端具倒刺。	Barbed at the tip.
胶黏的	Glutinous	胶质的；粘性的；被覆粘的分泌物。	Gluey; sticky; gummy; covered with a sticky exudation.
具长硬毛的	Hirsute	具有粗糙而坚硬的毛。	Pubescent with coarse, stiff hairs.
具微糙硬毛的	Hirsutulous	具有非常小的粗糙而坚硬的毛。	Pubescent with very small, coarse, stiff hairs.
具微糙硬毛的	Hirtellate	具有非常小的粗糙而坚硬的毛。	Pubescent with very small, coarse, stiff hairs.
具微糙硬毛的	Hirtellous	具有非常小的粗糙而坚硬的毛。	Pubescent with very small, coarse, stiff hairs.
具糙硬毛的	Hispid	粗糙具坚硬的毛。	Rough with firm, stiff hairs.
具短硬毛的	Hispidulous	细小的硬毛。	Minutely hispid.
具灰白毛的	Hoary	具灰色或白色的短细毛。	With gray or white short, fine hairs.
被细绢毛的	Holosericeous	被覆细的丝状毛。	Covered with fine, silky hairs.
被灰白毛的	Incanous	具发白的柔毛。	With a whitish pubescence.
无刺的	Inermous	无皮刺或棘。	Lacking spines, prickles, or thorns.
条裂的	Laciniate	裂成窄的不规则的圆裂片或条裂片。	Cut into narrow, irregular lobes or segments.
浅裂的	Lobed	裂片分裂不及基部或中脉的一半。	Bearing lobes which are cut less than half way to the base or midvein.
具小裂片的	Lobulate	具有小裂片。	With lobules.
多裂的	Multifid	半裂成许多狭窄的条裂片或圆裂片。	Cleft into many narrow segments or lobes.
掌状的	Palmate	自同一点上如手掌状分出。	Lobed, veined, or divided from a common point, like the fingers of a hand. (compare pinnate).
具微刺的	Spinulose	具微刺。	Bearing spinules.
具刺的	Spiny	具刺。	With spines.
具鳞片的	Squamate	被覆鳞片。	Covered with scales (squamae).
具小鳞片的	Squamulose	具小的鳞片。	With minute squamellae.
星状的	Stellate	星形的，如从基部辐射状分出多枝的毛。	Star-shaped, as in hairs with several to many branches radiating from the base.
短尖的	Mucronate	先端短而急尖（短尖头）。	Tipped with a short, sharp, abrupt point (mucro).
具小短尖的	Mucronulate	先端具极小短尖头。	Tipped with a very small mucro.
钝的	Muticous	钝，没有叶尖或刺。	Blunt, without a point or spine.
倒心形的	Obcordate	先端具深缺刻。	With a deeply notched apes.
钝的	Obtuse	先端钝圆；顶角大于90度。	Blunt or rounded at the apex; with the sides coming together a the apex at an angle greater than 90 degrees.
齿蚀状	Praemorse	骤然终止，如同被咬断的。	Terminating abruptly, as if bitten off.
锐尖的 辛辣的	Pungent	先端坚硬；气味或味道强烈刺激。	Tipped with a sharp, rigid point; with a sharp, acrid odor or taste.
微凹的	Retuse	圆或钝的先端具浅缺刻。	With a shallow notch in a round or blunt apex.
圆形的	Rounded	先端圆形。	With a rounded apex.
亚尖的，近尖的	Subacute	接近圆形。	Slightly acute.
截形的	Truncate	先端方形，刀切状。	With the apex squared at the end as if cut off.
偶数羽状的	Abruptly pinnate	顶端不具奇数小叶的羽状复叶。	Pinnate without an odd leaflet at the tip. Same as even-pinnate.
两叶的	Bifoliate	具有两片叶或小叶。	With two leaves or two leaflets.
二回羽状的	Bipinnate	二回复叶，二回羽裂。	Twice pinnate; with the divisions again pinnately divided.
二回三出的	Biternate	二回三出分裂。	Doubly ternate with the ternate divisions again ternate divided.
复叶	Compound leaf	具两枚或两枚以上小叶的叶。	A leaf separated into two or more distinct leaflets.
多回复叶	Decompound	一回以上的复叶，小叶多级。	More than once-compound, the leaflets again divided.
偶数羽状的	Even-pinnate	顶生一对小叶或卷须而非单枚顶生小叶的羽状复叶，因而小叶数为偶数。	Pinnately compound with a terminal pair of leaflets or a tendril rather than a single terminal leaflet, so that there is an even number of leaflets.
具小叶的	Foliolate	具小叶或与小叶相关的；如具两枚小叶或三枚小叶。	Pertaining to or having leaflets; usually used in compounds, such as bifoliolate or trifoliolate.
奇数羽状的	Imparipinnate	奇数羽状复叶，不等的羽状裂。	Odd-pinnate; unequally pinnate.
参差羽状的	Interruptedly pinnate	大小不同的小叶混合排列成的复叶。	Pinnate with leaflets of various sizes intermixed.
奇数羽状的	Odd-pinnate	顶生单枚小叶而非一对小叶或卷须的羽状复叶，因而小叶数为奇数。	Pinnately compound with a terminal leaflet rather than a pair of leaflets or a tendril, so that there is an odd number of leaflets.
掌状的	Palmate	自同一点上如手掌状分出的。	Lobed, veined, or divided from a common point, like the fingers of a hand. (compare pinnate)
羽状的	Pinnate	小叶沿长轴两侧相对排列的复叶。	A compound leaf with leaflets arranged on opposite sides of an elongated axis. (compared palmate)
单叶的	Simple	完整的，如叶片不分成小叶（但叶片可能深裂或具缺刻）	Undivided, as a leaf blade which is not separated into leaflets (though the blade may be deeply lobed or cleft).
卷须羽状复叶	Tendril-pinnate	羽状复叶，但顶端为卷须，如香豌豆。	Pinnately compound, but ending in a tendrill, as in the sweet pea.
三出的	Ternate	以三的数目，如具三枚小叶的复叶。	In threes, as a leaf which is divided into three leaflets.
具三叶的	Trifoliate	具三叶或三小叶	With three leaves or three leaflets.
具三叶的	Trifoliolate	具三叶或三小叶	With three leaves or three leaflets.
三回羽状的	Tripinnate	具羽状小羽片的三回羽状复叶。	Pinnately compound three times, with pinnate pinnules.
三回三出的	Triternate	三回三出	Triply ternate.
奇数羽状的	Unequally pinnate	顶生单枚小叶而非一对小叶或卷须的羽状复叶，因而小叶数为奇数。	Pinnately compound with a terminal leaflet rather than a pair of leaflets or a tendril, so that there is an odd number of leaflets.
具一小叶的	Unifoliate	理论上是复叶，实际为单个小叶，看似一枚单叶的叶子，如紫荆。	A leaf theoretically compound, though only expressing a single leaflet and appearing simple, as in Cercis.
叶（蕨类，棕榈，苏铁类）	Frond	大而分裂的叶；真蕨或棕榈叶。	A large, divided leaf; a fern or palm leaf.
联生叶的	Gamophyllous	叶联生，通常在叶缘相联。	With the leaves united, usually by the margins.
具异形叶的	Heterophyllous	同一植物上具有不同类型的叶子。	With different kinds of leaves on the same plant.
具异色边的	Limbate	具边的，如叶或花中一种颜色形成的边围绕着不同颜色的其它部分。	Bordered, as in a leaf or flower in which one color forms an edging or margin around another.
大型叶	Macrophyll	高等维管植物中相对大而伸展的叶。	The relatively large, expanded leaf of higher vascular plants.
凋存的	Marcescent	凋而不落，如某些花的萼片和花瓣或某些植物基部的叶片。	Withering but persistent, as the sepals and petals in some flowers or the leaves at the base of some plants.
具边的	Marginate	具有明显的边缘。	With a distinct margin.
基生叶茂盛的	Phyllopodic	最基部的叶发育良好，不退化为鳞片。	With the lowest leaves well developed, not reduced to scales.
具托叶的	Stipulate	具有托叶。	Bearing stipules.
肉质多汁的	Succulent	多汁且肉质，如芦荟属的叶片。	Juicy and fleshy, as the leaves of Aloe.
脉序	Venation	叶脉的式样。	The pattern of veining on a leaf.
具皮刺的	Aculeate	具皮刺的；被覆皮刺。	Prickly; covered with prickles.
被小刺的，稍具皮刺的	Aculeolate	具小皮刺的；被覆着小皮刺。	Minutely prickly; covered with tiny prickles.
蜂窝状的	Alveolar	蜂窝状，窝孔被薄的脊状隔壁分隔。	Honey-combed, with pits separated by thin, ridged partitions.
蜂窝状的	Alveolate	蜂窝状，窝孔被薄的脊状隔壁分隔。	Honey-combed, with pits separated by thin, ridged partitions.
有孔的	Aperturate	具一个或多个开口或孔。在花粉粒中，这些孔可能仅仅是薄的区域，而不是真正的穿孔。	With one or more openings or apertures. In pollen grains, these apertures may be only thin spots rather than actual perforations.
具蛛丝状毛的	Arachnoid	具有长的、蛛网似的、缠结在一起的毛。	Bearing long, cobwebby, entangled hairs.
银灰色的	Argenteous	具银色光泽的。	Silvery.
具刺的	Armed	具棘、刺、倒钩或皮刺。	Bearing thorns, spines, barbs, or prickles.
粗糙的	Asperous	手感粗糙。	Rough to the touch.
具短硬毛的，具倒刺毛的	Barbellate	具短而硬的毛或倒刺毛。	With short, stiff hairs or barbs.
具小短硬毛的，具小倒刺毛的	Barbellulate	具非常小的短硬毛或倒刺毛。	With very tiny short, stiff hairs or barbs.
具小叶柄的	Petiolulate	小叶具柄。	With a petiolule.
无柄的	Sessile	直接着生，无梗柄、如无柄的叶子。	Attached directly, without a supporting stalk, as a leaf without a petiole.
具鞘的	Sheathing	形成鞘，如禾草叶基部形成包裹着围茎的鞘。	Forming a sheath, as the leaf base of a grass forms a sheath as it surrounds the stem.
互生的	Alternate	每个节上着生一个，如茎上着生的叶。	Borne singly at each node, as leaves on a stem. (compare opposite)
基生的	Basal	位于或从基部发出，如叶从茎的基部发出。	Positioned at or arising from the base, as leaves arising from the base of the stem.
两侧的	Bilateral	排列在两边，如茎上着生的叶。	Arranged on two sides, as leaves on a stem.
茎生的	Cauline	叶从茎的地上部分发出。	Leaves arising from the stem above ground level.
交互对生的	Decussate	在茎上成对排列，相邻各对之间彼此呈直角。	Arranged along the stem in pairs, with each pair at right angles to the pair above or below.
右旋的	Dextrorse	向右转或向右螺旋排列，如叶片在一些基干上的排列方式。	Turned to the right or spirally arranged to the right, as in the leaves on some stems.
二列的	Distichous	在轴的相对两侧呈垂直的行或列排列。	In two vertical ranks or rows on opposite sides of an axis.
套折的	Equitant	两列间彼此交叠，如鸢尾属的叶。	Overlapping or straddling in two ranks, as the leaves of Iris.
对生的	Opposite	在同一节的相对两侧着生，如茎的一个节上着生两片叶子。	Borne across from one another at the same node, as in a stem with two leaves per node. (compare alternate).
成列的	Ranked	排列成竖行。	Arranged into vertical rows.
莲座丛	Rosette	叶子通常密集呈辐射状排列在地面或近地面上。	A dense radiating cluster of leafs usually at or near ground level.
莲座状的	Rosulate	基生莲座状排列，茎干极短或无。	With the leaves arranged in basal rosettes, the stem very short or lacking.
左旋的	Sinistrorse	向左转或向左螺旋排列，如某些茎上着生的叶。	Turned to the left or spirally arranged to the left, as in the leaves on some stems.
轮生的	Verticillate	成轮排列；轮生。	Arranged in vertical; whorled.
轮生的	Whorled	各部分成轮排列，如同在一节上发出3片或更多叶子，等同轮生的（verticillate）。	With parts arranged in whorled, as in a leaf arrangement with three or more leaves arising from a node.
拳卷的	Circinate	从顶端向下卷曲，如真蕨的幼叶。	Coiled from the tip downward, as in the young leaves of a fern.
具卷须的	Cirrhiferous	具有卷须。	Bearing a tendril.
摺叠的	Complicate	折叠在一起。	Folded together.
对折的	Conduplicate	上表面沿长轴折叠在一起，如许多禾草叶。	Folded together lengthwise with the upper surface within, as the leaves of many grasses.
脱落的	Deciduous	凋落，如叶从树上脱落；非常绿的；不宿存。	Falling off, as leaves from a tree; not evergreen; not persistent.
无托叶的	Estipulate	没有托叶。	Without stipules.
常绿的	Evergreen	在冬季也具绿色的叶子；非落叶的。	Having green leaves through the winter; not deciduous.
无托叶的	Exstipulate	没有托叶。	Without stipules.
针状的	Acerose	针形，如松或云杉的叶。	Needle-shaped, as the leaves of pine or spruce.
锥形的	Awl-shaped	短的，窄三角形的，锐尖如锥。	Short, narrowly triangular, and sharply pointed like an awl.
心形的	Cordate	心形，基部内凹。	Heart-shaped, with the notch at the base.
正三角形的	Deltoid	如希腊字母“Δ”形，形似等边三角形。	With the shape of the Greek letter delta; shaped like and narrower at the two equal ends.
具长柔毛的	Villose	具蓬松的非垫状长软毛。	Bearing long, soft, shaggy, but unmatted, hairs.
微柔毛的	Villosulous	小柔毛。	Diminutive if villous.
具长柔毛的	Villous	具蓬松的非垫状长软毛。	Bearing long, soft, shaggy, but unmatted, hairs.
黏的	Viscid	黏性的或胶性的。	Sticky or gummy.
微黏的	Viscidulous	稍黏。	Slightly sticky.
具绵状毛的	Woolly	具缠结的长软毛；绵状毛的。	With long, soft, entangled hairs; lanate.
苞片	Bract	在花或花序基部的退化的叶或叶状结构。	A reduced leaf or leaf-like structure at the base of a flower or inflorescence.
小苞片	Bracteole	着生于花序梗上的小的苞片。	A small bract borne on a peduncle.
小苞片	Bractlet	着生于花序梗上的小的苞片。	A small bract borne on a peduncle.
壳斗	Cupule	槲果杯状总苞	A cup-shaped involucre, as in an acorn.
花盘	Disk	菊科具总苞的的头状花序上着生管状花或心花的中央部分。	In the Compositae (Asteraceae), the central portion of the involucrate head bearing tubular or disk flowers.
副萼	Epicalyx	与外轮花萼相似的总苞，如锦葵属。	An involucre which resembles an outer calyx, as in Malva.
小花	Floret	小的花；密集花簇中的单个花，如禾草小穗中的一朵花，或者菊科头状花序中的一朵花。	A small flower; an individual flower within a dense cluster, as a grass flower in a spikelet, or a flower of the Compositae (Asteraceae) in an involucrate head.
花	Flower	植物的生殖部分，具雄蕊或雌蕊，或二者兼备，通常还包括由萼片或者由萼片和花瓣组成的花被。	The reproductive portion of the plant, consisting of stamens, pistils, or both, and usually including a perianth of sepals or both sepals and petals.
小总苞	Involucel	小型的总苞；二级总苞，如伞形科二级伞形花序的苞片。	A small involucre; a secondary involucre, as in the bracts of the secondary umbels in the Umbelliferae (Apiaceae).
总苞	Involucre	包被花或花簇的一轮苞片。	A whorl of bracts subtending a flower or flower cluster.
总苞	Involucrum (pl. Involucra)	包被花或花簇的一轮苞片。	A whorl of bracts subtending a flower or flower cluster.
花托	Torus (pl. tori)	着生花部器官的花梗部分；在菊科中指着生头状花序花的花序梗部分。	The portion of the pedicel upon which the flower parts are borne; in the Compositae (Asteraceae), the part of the peduncle where the flowers of the head are borne.
轮生	Whorl	自同一点或节上长出的相似部分的环状排列形式；环生。	A ring-like arrangement of similar parts arising form a common point or node; a verticil.
辐射对称	Actinomorphic	辐射状对称，通过结构中央的任一平面都能将其分成互为镜像的两部分。	Radially symmetrical, so that a line drawn through the middle of the structure along any plane will produce a mirror image on either side.
辐射对称	Actinomorphous	辐射状对称，通过结构中央的任一平面都能将其分成互为镜像的两部分。	Radially symmetrical, so that a line drawn through the middle of the structure along any plane will produce a mirror image on either side.
不整齐的	Irregular	两侧对称；指花各部分的大小及其在花托上的排列方式均不相似。	Bilaterally symmetrical; said of a flower in which all parts are not similar in size and arrangement on the receptacle.
两侧对称	Monosymmetrical	两侧对称。	Bilaterally symmetrical; zygomorphic.
反常整齐的	Peloria	两侧对称花中异常的辐射对称类型。	Radial symmetry in flowers normally bilaterally symmetrical.
整齐的	Regular	辐射对称；花各部分的大小及其在花托上的排列方式均相似。	Radially symmetrical; said of a flower in which all parts are similar in size and arrangement on the receptacle.
立体对称的	Stereomorphic	辐射对称，通过结构中央的任一平面都能将其分成互为镜像的两部分；基本等同辐射对称（actinomorphic）。	Radially symmetrical, so that a line drawn through the middle of the structure along any plane will produce a mirror image on either side; essentially the same as actinomorphic.
左右对称	Zygomorphic	两侧对称，仅在，通过结构中央仅有一个平面能将其分成互为镜像的两部分。	Bilaterally symmetrical, so that a line drawn through the middle of the structure along only one plane will produce a mirror image on either side.
左右对称的	Zygomorphous	两侧对称，仅在，通过结构中央仅有一个平面能将其分成互为镜像的两部分。	Bilaterally symmetrical, so that a line drawn through the middle of the structure along only one plane will produce a mirror image on either side.
上位的	Epigynous	雄蕊、瓣片和萼片着生于子房上部，子房位置低于其他花部。	With stamens, petals, and sepals attached to the top of the ovary, the ovary inferior to the other floral parts.
下位的	Hypogynous	雄蕊、瓣片和萼片着生于子房下部，子房位置高于其他花部。	With stamens, petals, and sepals attached below the ovary, the ovary superior to the other floral parts.
树干	Trunk	树的分枝以下的主茎。	The main stem of a tree below the branches.
块茎	Tuber	节和芽的地下茎的增粗部分；特化为储藏营养的地下茎。	The thickened portion of a rhizome bearing nodes and buds; underground stem modified for food storage.
具鳞根出条	Turion	常能越冬的小枝条，如柳叶菜属（epilobium）的某些种。	A small shoot which often over winters, as in some species of epilobium.
小枝	Twig	树上的小枝条。	A small shoot or branch from a tree.
藤本植物	Vine	具茎但不能靠自我支撑，而需要攀缘在其它支持物上生长的植物。	A plant with the stem not self-supporting, but climbing or t4railing on some support.
无茎的	Acaulescent	无茎或茎太短使得叶全为基生，如蒲公英。注意花序梗与茎的区别。	Without a stem, or the stem so short that the leaves are apparently all basal, as in the dandelion. Note : the peduncle should not be confused with the stem.
上升的	Adscendent	见上升的。斜向上生长，常有弯曲。	Growing Obliquely upward, usually curved.
上升的	Adsurgent	见上升的。斜向上生长，常有弯曲。	Growing Obliquely upward, usually curved.
具翅的	Alate	有翅的。	Winged.
二棱的	Ancipital	具两棱的，如唐菖蒲属（sisyrinchium）的具翅茎。茎具有双翼。	Two-edged, as the winged stem of sisyrinchium .
具棱的	Angulate	有角的。	Angled.
基生叶退化的	Aphyllopodic	最下部的叶退化成小的鳞片。	Having the lowermost leaves reduced to small scales.
无叶的	Aphyllous	没有叶。	Without leaves.
上升的	Ascendent	见上升的。斜向上生长，常有弯曲。	Growing Obliquely upward, usually curved.
半灌木的	Suffruticulose	轻度木质化。	Somewhat woody.
具根出条的	Surculose	从基部或根状茎上长出根出条或纤匐茎。	Producing suckers or runners from the base or from rootstocks.
地表的	Surficial	在近地面或地面上蔓生的。	Growing near the ground, or spread over the surface of the ground.
四棱的	Tetragonal	有四个棱角。	Four-angled.
蔓生的	Trailing	平卧匍匐生长，但不生根。	Prostrate and creeping but not tooting.
三棱的	Triangulate	三个棱角的。	Three-angled.
三棱的	Trigonal	三个棱角的。	Three-angled.
三棱的	Trigonous	有三个棱。	Three-angled.
丛生的	Tufted	密集成簇排列。	Arranged in a dense cluster.
缠绕的	Twining	围绕一个支撑物（如另一个茎）螺旋状盘绕支持物（常为其它茎）攀援生长。	Coiling or spiraling around a support (usually another stem ) for climbing.
无刺的	Unarmed	无刺，皮刺或棘刺。	Lacking spines, prickles, or thorns
单轴的	Uniaxial	单一不分枝的茎终止于花。	With a single unbranched stem terminating in a flower.
柔韧枝的	Vimineous	具有长而柔韧的小枝；由小枝组成；小枝状。	With long, flexible twigs; composed of twigs; twig like.
帚状的	Virgate	棒状的；细直，直立。	Wand like; straight, slender, and erect
具翅的	Winged	具有翅。	Possessing wings.
叶尖	Apex	尖端；距叶着生点最远的位点。	The tip; the point farthest from the point of attachment.
椭圆形的	Elliptic	椭圆或窄卵圆形；中部最宽，两端较窄。	In the shape of an ellipse, or a narrow oval; broadest at the middle and narrower at the two equal ends.
椭圆形的	Elliptical	椭圆或窄卵圆形；中部最宽，两端较窄。	In the shape of an ellipse, or a narrow oval; broadest at the middle and narrower at the two equal ends.
剑形的	Ensiform	形似剑，如鸢尾属（Iris）的叶。	Sword-shaped, as an Iris leaf.
镰刀形的	Falcate	形似镰刀；钩状；鹰喙状。	Sickle-shaped; hooked; shaped like the beak of a falcon.
扇形的	Flabellate	形状如扇。	Fan-shaped.
扇形的	Flabelliform	形状如扇。	Fan-shaped.
剑形的	Gladiate	形状如剑。	Sword-shaped.
戟形的	Halberd-shaped	箭头形，基部裂片向外而非向下；戟形。	Arrowhead-shaped, but with the basal lobes turned outward rather than downward; halberd-shaped. (compare sagittate)
戟形的	Hastate	箭头形，基部裂片向外而非向下；戟形。	Arrowhead-shaped, but with the basal lobes turned outward rather than downward; halberd-shaped. (compare sagittate)
披针形的	Lanceolate	矛形，长远大于宽，最宽部位在中部之下。	Lance-shape, much longer than wide, with the widest point below the middle.
①线形的②条形的	Linear	线状；长且窄，两边近平行。	Resembling a line; long and narrow with more or less parallel sides.
大头羽裂的	Lyrate	竖琴状、羽状的、顶端裂片大而圆、下部裂片甚小。	Lyre-shaped; pinnatifid, with the terminal lobe large and rounded and the lower lobes much smaller.
倒心形的	Obcordate	倒置心形，叶连接点在窄的末端；有时指描述端部具有深缺刻的叶。	Inversely cordate, with the attachment  at the narrower end; sometimes refers to any leaf with a deeply notched apes.
倒三角形的	Obdeltoid	三角形连接点在端点。	Deltoid, with the attachment at the at the narrower end; sometimes refers to any leaf with a deeply notched apex.
倒椭圆形	Obelliptic or obelliptical	几乎为椭圆形，但远轴端略大于近轴端。	Almost elliptic, but with the distal end somewhat larger than the proximal en.
倒披针形	Oblanceolate	倒置披针形，连接点在窄的末端。	Inversely Lanceolate.  With the attachment at the narrower end.
长圆形的	Oblong	两边近平行，长二至四倍于宽。	Two to four times longer than broad with nearly parallel sides.
倒卵形的	Obovate	倒置卵形，连接点在窄的末端。	Inversely ovate, with the attachment at the narrower end.
圆形的	Orbicular	轮廓近圆形。	Approximately circular in outline.
圆形的	Orbiculate	轮廓近圆形。	Approximately circular in outline.
卵圆形的	Oval	宽椭圆形，宽超过长的二分之一。	Broadly elliptic, the width over one-half the length.
卵形的	Ovate	轮廓卵形，基部宽（平面结构）。	Egg-shaped in outline and attached at the broad end (applied to plane surfaces).
提琴形的	Pandurate	形似提琴。	Fiddle-shaped.
提琴形的	Panduriform	形似提琴。	Fiddle-shaped.
盾形的	Peltate	形似盾；叶柄着生在叶的下表面，而不在叶的基部或边缘。	Shield-shaped; borne on a stalk attached to the lower surface rather than to the base or margin.
茎穿叶的	Perfoliate	叶边缘完全包围茎，使茎看似由叶片中心穿过。	A leaf with the margins entirely surrounding the stem, so that the stem appears to pass though the leaf.
方形的	Quadrate	正方形；矩形的。	Square; rectangular.
肾形的	Reniform	形似肾。	Kidney-shaped.
菱形的	Rhombic	形似钻石。	Diamond-shaped.
斜方形的	Rhomboid	近菱形,侧面为钝角的四边形。	Quadrangular, nearly rhombic, with obtuse lateral angles.
具乳突的	Papillate	具乳突。	Having papillae.
具小乳突的	Papillose	具小的乳突。	Having minute papillae.
乳突状硬毛的	Papillose-hispid	具膨大、乳突状基部的硬毛。	With stiff hairs borne on swollen, nipplelike bases.
纸质的	Papyraceous	质地通常似纸。	Papery in texture and usually color.
透明的	Pellucid	透明或半透明。	Transparent or translucent.
具孔的	Perforate	具孔或穿孔。	With holes or perforations.
具柔毛的	Pilose	具长、软、直的毛。	Bearing long, soft, straight hairs.
具小柔毛的	Pilosulose	具小的长、软、直的毛。	Bearing minute, long, soft, straight hairs.
具小柔毛的	Pilosulous	具小的长、软、直的毛。	Bearing minute, long, soft, straight hairs.
具洼点的	Pitted	具小孔穴或凹陷。	With small pits or depressions.
铅色的	Plumbeous	铅色。	Lead-colored.
具粉霜的	Pruinate	表面被蜡质的白粉；明显具粉，如梅干明显具白霜。	With a waxy, powdery, uaually whitish coating (bloom) on the surface; conspicuously glaucous, like a prune.
具粉霜的	Pruinose	表面被蜡质的白粉；明显具粉，如梅干明显具白霜。	With a waxy, powdery, uaually whitish coating (bloom) on the surface; conspicuously glaucous, like a prune.
被微柔毛的	Puberulent	具细小的绒毛；具细小短毛。	Minutely pubescent; with fine, short hairs.
具条纹的	Striate	具有细的通常是平行的线条或沟。	Marked with fine, usually parallel lines or grooves.
具短糙伏毛的	Strigillose	具小的毛。	Minutely strigose.
具糙伏毛的	Strigose	具直而坚硬的毡状毛。	Bearing straight, stiff, sharp, appressed hairs.
具短糙伏毛的	Strigulose	具小的毛。	Minutely strigose.
瘤状的	Strumose	具垫状隆起的盖层；泡状的。	With a covering of cushion-like swellings; bullate.
具槽的	Sulcate	具纵向的沟或槽。	With longitudinal grooves or furrows.
具方格斑纹的	Tesselate	具有棋盘格状的式样。	With a checkered pattern.
被短绒毛的	Tomentellous	稍具绒毛。	Slightly tomentose.
被绒毛的	Tomentose	被覆短垫状或缠结的软绵状毛；具绒毛。	With a covering of short, matted or tangled, soft, wooly hairs; with tomentum.
被微绒毛的	Tomentulose	稍具绒毛。	Slightly tomentose.
半透明的	Translucent	几乎透明。	Almost transparent.
无刺的	Unarmed	无皮刺或棘。	Lacking spines, prickles, or thorns.
具钩的	Uncinate	顶端具钩。	Hooked at the tip.
刺人的	Urent	蛰人的。	Stinging.
被短绒毛的	Velutinous	被茸毛的；被覆散生的、柔软的短毛。	Velvety; covered with short, soft, spreading hairs.
疣状的	Verrucose	有疣的；被覆疣状突起。	Warty; covered with wart-like elevations.
茎基	Caudex (pl. Caudices, caudexes)	多年生草本植物宿存的木质化的基部。	The persistent and often woody base of a herbaceous perennisl.
皮层	Cortex	树皮；位于根表皮和中柱之间的组织。	Bark or rind; root tissue between the epidermis and the stele.
根茎、树冠	Crown	多年生草本植物宿存的基部，茎基。图1484。树的顶部。	The persistent base of a herbaceous perennial, a caudex. 4; the top part of a tree.
上升的	Ascending	见上升的。斜向上生长，常有弯曲。	Growing Obliquely upward, usually curved.
上升的	Assurgent	见上升的。斜向上生长，常有弯曲。	Growing Obliquely upward, usually curved.
丛生的	Caespitose	密集呈族生长。	Growing in dense tufts.
具茎的	Caulescent	在地上具有明显多叶的茎。	With an obvious leafy stem rising above the ground.
茎生花的	Cauliflorous	茎上或树干上生花。	Bearing flowers on the stem or trunk.
茎生的	Cauline	茎的、茎上的或与茎相关的。	Of, on, or pertaining to the stem.
丛生的	Cespitose	密集呈族生长。	Growing in dense tufts.
攀援的	Clambering	松散地沿其他植物或周围物体攀援生长。	Weakly climbing on other plants or surrounding objects.
攀援的	Climbing	依靠或缠绕其他支撑物多少直立生长。	Growing more or less erect by leaning or twining on another structure for support.
匍匐的	Creeping	 沿地表或近靠地面生长，通常在节处生根。	Growing along the surface of the ground, or just beneath the surface, and producing toots, usually at the nodes
外顷的	Decumbent	匐于地面生长，但端部向上。	Reclining on the ground but with the tip ascending.
歧散的	Deliquescent	无规则的分枝形式，从底部到顶部无固定的中心轴。	An irregular pattern of branching without a well defined central axis from bottom to top.
二歧的	Dichotomous	具多少相等的两个分枝或分叉。	Branched or forded into two more or less equal divisions.
极叉开的	Divaricate	宽角度地分叉或展开	Widely diverging or spreading apart.
分叉的	Divergent	分叉或展开。	Diverging or spreading.
不分枝的	Eramous	茎不分枝。	With unbranched stems.
直立的	Erect	垂直的，不倾斜或不展开	Verticlal, not declining or spreading.
扁化的	Fasciated	压成束状或带状；紧密地生长在一起；茎畸形扁化，好象几个分离的茎融合。	Compressed into a bundle or band; grown closely together; with the stems malformed and flattened as if several separate stems had been fused together.
束状的	Fasciculate	成束排列。	Arranged in fascicles.
帚状的	Fastigiate	成簇的、平行且直立，外形扫帚状。	Clustered, parallel, and erect, giving a broom-like appearance.
肉质的	Fleshy	厚而多肉，多汁的。	Thick and pulpy; succulent.
近灌木状的	Frutescent	灌木状的或似灌木状的。	Shrubby or shrublike.
灌木状的	Fruticose	灌木状的或似灌木状的。	Shrubby or shrublike.
小灌木状的	Fruticulose	稍灌木状，小灌木状。	Somewhat shrubby; small and shrubby.
草本的	Herbaceous	非木本。	Not woody.
具关节的	Jointed	具有节或关节，如仙人掌（Opunitia）属的茎。	Having nodes or points of articulation, as in the stems of Opunitia.
具长枝的	Macrocladous	具有长枝。	With long branches.
被微柔毛的	Puberulous	具细小的绒毛；具细小短毛。	Minutely pubescent; with fine, short hairs.
被短柔毛的	Pubescent	被覆短而软的毛；被毛。	Covered with short, soft hairs; bearing any kind of hairs.
粉状的	Pulverulent	呈粉末状或粉状。	Appearing dusty or powdery.
具点的	Punctate	由凹陷或半透明下陷的腺体或色斑形成斑点。	Dotted with pits or with translucent, sunken glands or with colored dots.
具小点的	Puncticulate	小的斑点。	Minutely punctate.
疱状突起的	Pustular	通常在毛的基部小的疱疹状突起。	With small blisters or pustules, often at the base of a hair.
疱状突起的	Pustulate	通常在毛的基部小的疱疹状突起。	With small blisters or pustules, often at the base of a hair.
疱状突起的	Pustuliferous	通常在毛的基部小的疱疹状突起。	With small blisters or pustules, often at the base of a hair.
疱状突起的	Pustulose	通常在毛的基部小的疱疹状突起。	With small blisters or pustules, often at the base of a hair.
具小鳞片的	Ramentaceous	具有扁平的、鳞片状的突起，如某些真蕨茎和叶的表皮。	With flattened, scaly outgrowths, as on the epidermis of the stem and leaves of some ferns.
露湿状的	Roridulate	被覆看似湿润的蜡质小板状覆盖层。	With a covering of waxy platelets, appearing moist.
有皱的	Rugate	起皱。	Wrinkled.
微皱的	Rugulose	稍起皱。	Slightly wrinkled.
嚼烂状的	Ruminate	粗糙地褶皱，好象被嚼烂过似的。	Roughly wrinkled, as if chewed.
微糙的	Scaberulent	由于表皮细胞的结构或存在短刚毛，手感稍糙。	Slightly rough to the touch, due to the structure of the epidermal cells, or to the presence of short stiff hairs.
微糙的	Scaberulose	由于表皮细胞的结构或存在短刚毛，手感稍糙。	Slightly rough to the touch, due to the structure of the epidermal cells, or to the presence of short stiff hairs.
微糙的	Scaberulous	由于表皮细胞的结构或存在短刚毛，手感稍糙。	Slightly rough to the touch, due to the structure of the epidermal cells, or to the presence of short stiff hairs.
微糙的	Scabrellate	由于表皮细胞的结构或存在短刚毛，手感稍糙。	Slightly rough to the touch, due to the structure of the epidermal cells, or to the presence of short stiff hairs.
粗糙的	Scabrid	粗糙。	Roughened.
微糙的	Scabridulous	微粗糙。	Minutely roughened.
粗糙的	Scabrous	由于表皮细胞的结构或短刚毛，手感稍糙。	Rough to the touch, due to the structure of the epidermal cells, or to the presence of short stiff hairs.
具鳞屑的	Scurfy	被覆小的糠秕状的鳞片。	Covered with small, bran-like scales.
被绢毛的	Sericeous	丝质的，具毡状细软的长毛。	Silky, with long, soft, slender, somewhat appressed hairs.
具刚毛的	Setose	被覆刚毛。	Covered with bristles.
具小刚毛的	Setulose	被覆小的刚毛。	Covered with minute bristles.
绢状的	Silky	外观或质地丝状；被绢毛。	Silk-like in appearance or texture; sericeous.
平滑的	Smooth	表面平；手感不糙。	With an even surface; not rough to the touch.
具刺的	Spiniferous	具刺。	Bearing spines.
具刺的	Spinose	具刺。	Bearing spines.
具刺的	Spinous	具刺。	Bearing spines.
周位的	Perigynous	雄蕊、瓣片和萼片着生于花萼筒上（托杯），花萼筒环绕、但并不真正接触上位子房。	With stamens, petals, and sepals borne on a calyx tube (hypanthium) surrounding, but not actually attached to, the superior ovary.
风媒的	Anemophilous	靠风传粉；产生风媒性花粉。	Wind pollinated; producing wind-borne pollen.
开花受精的	Chasmogamous	常指异花传粉的花在受精前开放。	Applied to flowers which open before fertilization and are usually cross-pollinated. (compare cleistogamous)
闭花受精的	Cleistogamous	指在未开放时进行自花受精的花。（对比开花受精的）。	Said of flowers which self-fertilize without opening. (compare chasmogamous)
雌雄蕊异熟的	Dichogamic	雌蕊和雄蕊在不同时间成熟以避免自花受精。（对比雌雄同熟）。	With the pistils and stamens maturing at different times to prevent self-fertilization. (compare homogamous)
雌雄异熟的	Dichogamous	雌蕊和雄蕊在不同时间成熟以避免自花受精。（对比雌雄同熟）。	With the pistils and stamens maturing at different times to prevent self-fertilization. (compare homogamous)
虫媒的	Entomophilous	靠昆虫传粉。	Insect pollinated.
同株异花受精的	Geitonogamous	同一植株的花相互传粉。	Pollinated by flowers of the same plant.
雌雄同熟的	Homogamous	雌蕊和雄蕊同时成熟以便自花受精。（对比雌雄异熟）。	With the pistils and stamens maturing at the same time, allowing self-fertilication. (compare dichogamous)
闭花受精的	Kleistogamous	指在未开放时进行自花受精的花。（对比开花受精的）。	Said of flowers which self-fertilize without opening. (compare chasmogamous)
雌花先熟的	Metandrous	雌花先于雄花成熟；雌先熟的。	With the female flowers maturing before the male flowers; protogynous.
鸟媒的	Ornithophilous	靠鸟传粉。	Pollinated by birds.
异花传粉	Outcrossing	一个植株花药的花粉传送到另一植株花的柱头上。	Transferring pollen from the anthers of the flowers of one plant to the stigma of the flower of another plant.
雄蕊先熟	Protandrous	在柱头可以受粉前花药释放花粉。	With the anthers releasing pollen before the stigma is receptive.
雄蕊先熟的	Proterandrous	在柱头可以受粉前花药释放花粉。	With the anthers releasing pollen before the stigma is receptive.
雌蕊先熟的	Proterogynous	柱头在花药释放花粉前即可受粉。	With the stigma receptive before the anthers release pollen.
雌蕊先熟的	Protogynous	柱头在花药释放花粉前即可受粉。	With the stigma receptive before the anthers release pollen.
自花传粉	Self-pollinating	花药中的花粉传送到同一朵花的柱头上或同一植株其他花的柱头上。	Transferring pollen from the anthers to the stigma of the flower or to the stigma of another flower on the same plant.
雄全异株，雄花两性花异株	Andro-dioecious	雄花和完全花分别在不同的植株上。	With staminate and perfect flowers on separate plants.
雄全同株，雄花两性花同株	Andro-monoecious	雄花和完全花在同一植株上。	With staminate and perfect flowers on the same plant.
雄全同株，雄花两性花同株	Andro-polygamous	雄花和完全花在同一植株上。	With staminate and perfect flowers on the same plant.
两性的	Bisexual	同一朵花内具有雄性和雌性生殖器官（雄蕊和雌蕊）。（等同完全的）	With both male and female reproductive organs (stamens and pistils). (same as perfect)
雌雄异花的	Diclinous	雄蕊和雌蕊位于不同的花中；不完全的。	With the stamens and pistils in separate flowers; imperfect.
雌雄异株的	Dioecious	具不完全花，生于雄花和雌花分别在不同的植株上。（对比雌雄同株的）。	With imperfect flowers, the staminate and pistillate flowers borne on different plants. (compare monoecious)
雌雄异株的	Dioicous	具不完全花，生于雄花和雌花分别在不同的植株上。（对比雌雄同株的）。	With imperfect flowers, the staminate and pistillate flowers borne on different plants. (compare monoecious)
雌雄异株的	Diecious	具不完全花，生于雄花和雌花分别在不同的植株上。（对比雌雄同株的）。	With imperfect flowers, the staminate and pistillate flowers borne on different plants. (compare monoecious)
雌全异株的，雌花两性花异株	Gyno-dioecious	雌花和完全花分别在不同的植株上。	With pistillate and perfect flowers on separate plants.
两性的	Hermaphroditic	在一朵花内具雄蕊和雌蕊；两性的；雌雄蕊同花的；完全的。	With pistils and stamens in the same flower; bisexual; monoclinous; perfect.
具两类花的	Heterogamous	具有不同性别的花。	With flowers of differing sex.
不完全的	Imperfect	一朵花内仅具有雄蕊或雌蕊；单性的。	With either stamens or pistils, but not both; unisexual.
雌雄同株的	Monecious	不完全花，即雄花和雌花长在同一个植株上。（对比雌雄异株）。	Flowers imperfect, the staminate and pistillate flowers borne on the same plant. (compare dioecious)
雌雄蕊同花的	Monoclinous	一朵花内具雄蕊和雌蕊；完全的。	With pistils and stamens in the same flower; perfect.
雌雄同株的	Monoecious	不完全花，即雄花和雌花长在同一个植株上。（对比雌雄异株）。	Flowers imperfect, the staminate and pistillate flowers borne on the same plant. (compare dioecious) 
完全的	Perfect	同一朵花内具有雄性和雌性生殖器官（雄蕊和雌蕊）；两性的。	With both male and female reproductive organs (stamens and pistils); bisexual.
雌蕊的	Pistillate	具有一个或多个雌蕊，但无雄蕊。（对比雄蕊的）。	Bearing a pistil or pistils, but lacking stamens. (compare staminate)
杂性异株的	Polygamo-dioecious	以雌雄异株为主，夹杂完全花。	Mostly dioecious, but with some perfect flowers.
杂性同株的	Polygamo-monoecious	以雌雄同株为主，杂完全花。	Mostly monoecious, but with some perfect flowers.
杂性的	Polygamous	单性花和两性花在同一植株上。	With unisexual and bisexual flowers on the same plant.
雄蕊花	Staminate	具有雄蕊，但不具雌蕊，如不产生果实和种子的雄花。（对比雌蕊的）	Bearing stamens but not pistils, as a male flower which does not produce fruit or seeds. (compare pistillate)
单全异株，单性花完全花异株	Triecious	雄花、雌花和两性花生于不同的植株上。	With male, female, and bisexual flowers on different plants.
单全异株，单性花完全花异株	Trioecious	雄花、雌花和两性花生于不同的植株上。	With male, female, and bisexual flowers on different plants.
单性的	Unisexual	一朵花内仅具雄性或雌性生殖部分。	With either male or female reproductive parts, but not both.
昼开性的	Diurnal	在白天发生或开放。	Occurring or opening in the daytime.
定时开花的	Equinoctial	有规律地在一天中的特定时间开放。	With flowers that open regularly at a particular hour of the day.
冬季开花的	Hibernal	在冬季开放。	Flowering in the winter.
托叶鞘	Ocreola (pl. ocreolae)	某些蓼科植物中，围绕花序次级分枝的托叶状小鞘。	A minute stipular sheath around the secondary divisions of the inflorescence in some members of the Polygonaceae.
花梗	Pedicel	花序中单朵花的柄，或禾草小穗的柄。	The stalk of a single flower in an inflorescence, or of a grass spikelet.
花序梗	Peduncle	单生花或整个花序的柄。	The stalk of a solitary flower or of an inflorescence.
雌器苞	Perigynium (pl. perigynia)	苔草属中,包被雌蕊的鳞片状苞片。	A scale-like bract enclosing the pistil in Carex.
总苞片	Phyllary	菊科总苞的苞片。	An involucral bract of the Compositae (Asteraceae).
小穗轴	Rachilla	禾草或莎草小穗的轴；小轴。	The axis of a grass or sedge spikelet; a small rachis.
花序轴	Rachis	花序的主轴。	The main axis of an inflorescence.
伞辐	Ray	伞形花序的花序分枝。	An inflorescence branch in an umbel.
花葶	Scape	无茎植物从地表（通常自基生莲座）抽出的无叶花序梗。	A leafless peduncle arising from ground level (usually from a basal rosette) in acaulescent plants.
副花梗	Secondary peduncle	花序分枝。	An inflorescence branch.
佛焰苞	Spathe	侧展并半包围或全包花个的一片或一对大苞片。	A large bract or pair of bracts subtending and often enclosing an inflorescence.
总苞片	Tegule	菊科总苞的一枚苞片。	One of the bracts of the involucre in the Compositae (Asteraceae).
柔荑花序	Ament	由无被单性花组成的密集的穗状或总状花序，如杨柳科和桦木科。	An inflorescence consisting of a dense spike or raceme of apetalous, unisexual flowers， as in Salicaceae and Betulaceae; an ament.
小头花状序	Capitulum	小的头状花序。	A small flower head.
柔荑花序	Catkin	由无被单性花组成的密集的穗状或总状花序，如杨柳科和桦木科。	An inflorescence consisting of a dense spike or raceme of apetalous, unisexual flowers， as in Salicaceae and Betulaceae; an ament.
异基数的	Heteromerous	各花部组成数目有变化，如一朵花各轮的数目彼此不同。	With a variable number of parts, as in a flower with a different number of members in each floral whorl.
六基数的	Hexamerous	以六的倍数成组排列。	With parts arranged in sets or multiples of six.
不完全的	Incomplete	缺少某个或多个花部结构，如一朵花缺少一轮花部结构（萼片、花瓣、雄蕊或雌蕊）。	Lacking an expected part or series of parts, as in a flower lacking one of the floral whorls (I.e. sepals, petals, stamens, or pistils).
等基数的	Isomerous	各花部组成数目相等，如一朵花各轮的数目彼此相等。	With an equal number of parts, as in a flower with an equal number of members in each floral whorl.
单轮的	Monocyclic	仅具一轮。	With a single whorls.
单基数的	Monomerous	仅具一个组分，如花轮仅具一枚。	With a single member, as in a floral whorl with only one part.
五轮的	Pentacyclic	具五轮。	With five whorls.
五基数的	Pentamerous	以为五的倍数成组排列。	With parts arranged in sets or multiples of five.
多轮的	Polycyclic	具多轮。	With many whorls.
多基数的	Polymerous	具多个组成部分，如花轮中具有多个组分。	With many part, as in a floral whorl with many members.
相等的	Symmetric	花部各轮数目相同。	Said of a flower having the same number of parts in each floral whorl.
四基数的	Tetramerous	以四的倍数成组排列。	With parts arranged in sets or multiples of four.
三基数的	Trimerous	以三的倍数成组排列。	With parts arranged in sets or multiples of three.
翼瓣	Ala (pl. alae)	蝶形花冠的两侧花瓣。	One of the two lateral petals of a papilionaceous corolla.
前唇瓣	Anterior lip or lobe	唇形花冠的下方唇瓣。	The lower lip of a bilabiate corolla. (compare posterior)
旗瓣	Banner	蝶形花冠的上方通常最大的花瓣，如豌豆和香豌豆。	The upper and usually largest petal of a papilionaceous flower, as in peas and sweet peas.
瓣片	Blade	花瓣宽展的部分	The broad part of a petal.
鳞桥	Bridge	连接花冠鳞片的带状结构组织，如菟丝子属（Cuscuta）。	A band of tissue connecting the corolla scales, as in Cuscuta.
瓣距	Calcar	距或距状附属物。	A spur or spurlike appendage.
萼檐	Calyx limb	合生萼片的分离部分。	One of the free portions of a calyx of united sepals.
萼裂片	Calyx lobe	合生萼片的分离部分。	One of the free portions of a calyx of united sepals.
萼齿	Calyx tooth	合生萼片的分离部分。	One of the free portions of a calyx of united sepals.
萼筒	Calyx tube	合生萼的筒状联合部分。	The tube-like united portion of a clayx of united sepals.
①龙骨瓣②龙骨状突起	Carina	龙骨状突起或脊。	A keel or ridge.
瓣爪	Claw	某些花瓣或萼片变窄的基部。	The narrowed base of some petals and sepals.
花冠裂片	Corolla lobe	合生花冠的分离部分。	One of the free portions of a corolla of united petals.
花冠筒	Corolla tube	合生花瓣的柱状、中空部分。	The hollow, cylindric portion of a corolla of united petals.
副花冠	Corona	某些花中，花瓣和雄蕊之间的瓣状或冠状结构。	Petal-like or crown-like structures between the petals and stamens in some flowers; a crown.
鸡冠状突起	Crest	隆起的脊或肋状凸起。	An elevated ridge or rib.
副花冠	Crown	某些花中，花瓣和雄蕊之间的瓣状或冠状结构。	Petal-like or crown-like structures between the petals and stamens in some flowers; a crown.
蝎尾状聚伞花序	Cincinnus	密集的螺旋状聚伞花序，花梗在花序发育一侧渐短。	A dense helicoid cyme with the pedicels short on the developed side.
伞房花序	Corymb	顶部平或圆的花序，总状，但下部花梗长于上部花梗。	A flat-topped or round-topped inflorescence, racemose, but with the lower pedicels longer than the upper.
杯状聚伞花序	Cyathium (pl. caythia)	大戟属由杯状总苞组成的花序总苞中包含一枚雌蕊雌花和多朵单雄蕊雄花。	The inflorescence in the genus Euphorbia, consisting of a cup-like involucre containing a single pistil and male flowers with a single stamen.
聚伞花序	Cyme	顶部平或圆的有限花序，圆锥状，顶端花先开放。	A flat-topped or round-topped determinate inflorescence, paniculate, in which the terminal flower blooms first.
小聚伞花序	Cymule	小的聚伞花序或复合聚伞花序的一小部分。	A small cyme or a small section of a compound cyme.
二歧聚伞花序	Dichasium	每个花分为两条相对或近相对的侧轴的聚伞花序。	A cymose inflorescence in which each axis produces two opposite or subopposite lateral axes.
团伞花序	Glomerule	密集的花簇；头状密集的聚伞花序。	A dense cluster; a dense, head-like cyme.
头状花序	Head	无柄或近无柄的花密集成簇而成的花序；菊科的具总苞花序。	A dense cluster of sessile or subsessile flowers; the involucrate inflorescence of the Compositae (Asteraceae).
螺卷聚伞花序	Helicoid cyme	一侧发育而卷曲如螺旋的聚伞花序。	A one-sided cymose inflorescence coiled like a spiral or helix.
隐头花序	Hypanthodium	由着生于头状花序壁上的花组成的花序，如榕属的花序。	An inflorescence with flowers borne on the walls of a capitulum, as in Ficus.
居间花序	Intercalary inflorescence	花形成以后营养主轴依然延长的花序。	An inflorescence type in which the main vegetative axis of the plant continues to elongate after the flowers are produced.
混合花序	Mixed inflorescence	具有总状部分和聚伞状部分的花序。	An inflorescence with both racemose and cymose portions.
单歧聚伞花序	Monochasium	具有单一主轴的聚伞花序类型。	A type of cymose inflorescence with only a single main axis.
圆锥花序	Panicle	花自基部向上依次成熟、具分支的总状花序。	A branched, racemose inflorescence with flowers maturing from the bottom upwards. 
多歧聚伞花序	Pleiochasium	从主轴分出两个以上分支的聚伞状花序。	A cymose inflorescence with more than two branches from the main axis.
多头聚伞花序	Polychasium	每个轴具两个以上侧轴的聚伞花序。	A cymose inflorescence in which each axis produces more than two branches.
晨开性的	Matutinal	在早晨开放。	Opening in the morning.
夜开性的	Nocturnal	在夜间开放。	Opening at night.
夜间开花的	Nyctanthous	夜间开花。	Night-flowering.
夜开的	Nyctigamous	在夜间开放。	Opening at night.
先有花的	Precocious	花发育早于叶。	With the flowers developing before the leaves.
先有花的	Proteranthous	花发育早于叶。	With the flowers developing before the leaves.
四季开花的	Semperflorous	整年都开花。	Flowering throughout the year.
迟季开花的	Serotinous	晚开花；花在叶充分发育后开放。	Flowering late; with flowers developing after the leaves are fully developed.
春季开花的	Vernal	在春季开花。	Flowering in the spring.
暮开性的	Vespertine	在傍晚开放。	Opening in the evening.
不同数的	Anisomerous	花部中不成轮部分的数目不同于（通常少于）成轮部分的数目，如一朵花具有五枚萼片和花瓣，却只有两枚雄蕊。	With a different number of parts (usually less) than the other floral whorls, as in a flower with five sepals and petals, but only two stamens.
完全的	Complete	花部齐全，如一朵花具有萼片、花瓣、雄蕊和雌蕊。	With all of the parts typically belonging to it, as a flower with sepals, petals, stamens, and pistils.
二轮列的	Dicyclic	具两轮。	With two whorls.
二基数的	Dimerous	以二的倍数成组排列。	With parts arranged in sets or multiples of two.
盔瓣	Cucullus	兜状瓣。	A hood.
副萼	Epicalyx	类似外层花萼的总苞，如锦葵属。	An involucre which resembles an outer calyx, as in Malva.
下垂萼片	Falls	鸢尾属的花瓣。	The sepals of an Iris.
花被管	Floral tube	花被筒状伸长的部分。	An elongated tubular portion of a perianth. See illustration for corolla tube.
冠筒鳞片	Fornix (pl. fornices)	花冠喉部着生的多个小突隆起或鳞片，如紫草科（Boraginaceae）。	One of a set of small crests or scales in the throat of a corolla, as in many of the Boraginaceae. See illustration for corona.
流苏	Fringed	沿边缘的毛或刚毛。	Hairs or bristles along the margin.
盔瓣	Galea	两个唇瓣的花冠盔状或兜状的上唇瓣。	The helmet-shaped or hood-like upper lip of some two-lipped corollas.
隆凸	Gibbosity	囊状膨大或隆起；隆起状态．	A swelling or protuberance; the state of being gibbous.
盔瓣	Helmet	拱曲中空的被片，如乌头属的上方花瓣。	A hollow, arched covering, as the upper petal in Aconitum.
兜状瓣	Hood	拱曲中空的被片，如乌头属的上方花瓣。	A hollow, arched covering, as the upper petal in Aconitum.
角状突起	Horn	像牛角一样渐尖的突起。	A tapering projection resembling the horn of a cow.
龙骨瓣	Keel	蝶形花下部的两枚基部联合的花瓣。	The two lower united petals of a papillonaceous flower.
唇瓣	Labellum	唇；兰花特化的花瓣。	Lip; the exceptional petal of an orchid blossom.
下唇瓣	Labium (pl. labia)	唇形花冠的下唇。	The lower lip of a bilabiate corolla.
副花冠裂片	Lamella (pl. lamellae)	着生在某些花冠的花瓣上并参与副花冠形成的直立的鳞片。	An erect scale inserted on the petal in some corollas and forming part of the corona. See illustration for corona.
片	Lamina	叶或花瓣的宽展部分。	The expanded portion, or blade, of a petal.
腺瓣	Lepanthium	具腺体的花瓣。	A petal with nectary.
舌瓣	Ligula	菊科放射状花冠的扁平部分。	The flattened part of the ray corolla in the Compositae (Asteraceae).
冠檐	Limb	花瓣的开张部分或瓣片，图 1762；合瓣花冠的开张部分，图 1778。	The expanded part, or blade, of a petal; the expanded part of a sympetalous corolla.
唇	Lip	不规则二唇形花冠或花萼的突起或裂片；下唇瓣，图 1776；兰花特化的花瓣。图 1775。	One of the two projections or segments of an irregular, two-lipped corolla or calyx; a labium; the exceptional petal of an orchid blossom.
浆片	Lodicule	禾草花子房基部成对的、未发育的鳞片	Paired, rudimentary scales at the base of the ovary in grass flowers.
口	Orifice	开口如管状花冠的口状张开。	An opening or mouth, as the mouth-like opening of a tubular corolla.
喉凸	Palate	花冠下唇上隆起的部分或完全堵塞的附属物。	A raised appendage on the lower lip of a corolla which partially or completely closes the throat.
冠毛	Pappus	菊科的变态花萼，由着生于瘦果顶部的芒、鳞片或刚毛组成。	The modified calyx of the Compositae (Asteraceae), consisting of awns, scales, or bristles at the apex of the achene.
花瓣	Petal	花冠的单个裂片或组分，通常有色或白色。	An individual segment or member of the corolla, usually colored or white.
褶	Plait	叠或褶如某些花冠。	A fold or pleat, as in some corolla.
后唇瓣	Posterior	二唇形花冠的上唇。	The upper lip of a bilabiate corolla. (compare anterior)
边花	Ray	菊科舌状花的舌形部分（或舌状花本身）。	The strap-like portion of a ligulate flower (or the ligulate flower itself) in Compositae (Asteraceae).
囊	Sac	袋状结构。	A bag-like structure.
鳞片	Scale	任何薄而扁平的膜质结构。	Any thin, flat, scarious structure.
龙骨状的	Keeled	具脊，像船的龙骨。	Ridged, like the keel of a boat.
唇形的	Labiate	唇状；排列成唇形或呈唇形的。	Lipped; with parts which are arranged like lips or shaped like lips.
舌状的	Ligulate	舌形。	Strap-shaped.
舌状的	Liguliform	舌形。	Strap-shaped.
具浆片的	Paleolate	具浆片。	With a lodicule.
蝶形的	Papilionaceous	像蝴蝶，如豌豆的不整齐花冠，具有一枚旗瓣、两枚翼瓣和两枚龙骨瓣。	Butterfly-like, as the irregular corolla of a pea, with a banner petal, two wing petals, and two fused keel petals.
假面状的	Personate	具二唇，喉部被显著的突起（喉凸）封闭。	Two-lipped, with the throat closed by a prominent projection (palate).
折扇状的	Plicate	折或叠如折扇。	Plaited or folded, as a folding fan.
前伸的	Porrect	向前延伸；类似鹦鹉的喙。	Extended forward; resembling a parrot beak.
反折的	Reflexed	向后或向下弯曲。	Bent backward or downward.
开口的	Ringent	张开的；如一些花冠中的宽张的唇瓣。	Gaping; with widely spreading lips, as in some corollas.
辐状的	Rotate	盘形；平坦而圆，如合瓣花冠裂片平展，冠筒很短或无。	Disc-shaped; flat and circular, as a sympetalous corolla with widely spreading lobes and little or no tube.
囊状的	Saccate	具囊或呈囊形。	With a sac, or in the shape of a sac.
高脚碟状的	Salverform	冠筒细长，上部陡扁平张开。	With a slender tube and an abruptly spreading, flattened limb.
具距的	Spurred	具一枚或多枚距。	Bearing a spur or spurs.
舌状的	Strap-shaped	平而伸展。	Elongated and flat.
管状的	Tubular	形状如管或圆柱。	With the form of a tube or cylinder.
坛状的	Urceolate	像水罐；中空、口部缢缩如水罐或瓮。	Pitcher-like; hollow and contracted near the mouth like a pitcher or run.
坛状的	Urn-shaped	像水罐；中空、口部缢缩如水罐或瓮。	Pitcher-like; hollow and contracted near the mouth like a pitcher or run.
一侧臌的	Ventricose	仅在一侧膨大或鼓起，如某些花冠，尤其钓钟柳属。	Inflated or swollen on one side only, as in some corollas, especially in the genus Penstemon.
具翅的	Winged	具有翅。	Possessing wings.
雌雄蕊柄	Androgynophore	某些花中着生雄蕊和雌蕊的柄。	Stalk supporting the androecium and gynoecium in some flowers.
雄蕊柄	Androphore	着生一组雄蕊的柄。	Stalk supporting a group of stamens.
花药	Anther	雄蕊顶端产生花粉的膨大部位。	The expanded, apical, pollen bearing portion of the stamen.
药囊	Anther sac	花粉中产生花药的小室。	One of the pollen bearing chambers of the anther.
室	Cell	结构内的空腔或小室，如容纳花粉的花药室。	A hollow cavity or compartment within a structure, as the cavity of the anther containing pollen.
①柱②蕊柱	Column	雄蕊花丝联合形成的结构。兰科植物中花丝和花柱的联合体。图1810。	A structure formed by the union of staminal filaments. The united filaments and style in the Orchidaceae.
药隔	Connective	雄蕊上连接花药两个花粉囊的部分。	The portion of the stamen connecting the two pollen sacs of an anther.
花丝	Filament	雄蕊中支撑花药的柄。	The stalk of the stamen which supports the anther.
合蕊柱	Gynandrium	着生雄蕊和雌蕊的柱状结构。	A column bearing stamens and pistils.
萼片	Sepal	花萼的一个裂片。	A segment of the calyx.
凹缺	Sinus	花瓣两裂片之间的裂缺、凹陷或缺口。	The cleft, depression, or recess between two lobes of a petal.
距	Spur	萼片或花瓣、花萼或花冠上的、细小的、囊状、中空的附属结构。	A hollow, slender, sac-like appendage or a petal of sepal, or of the clayx or corolla.
鳞片	Squama (pl. squamae)	一种鳞片，如菊科冠毛的某些类型	A scale, as in some types of pappus in the Compositae (Asteraceae).
旗瓣	Standard	蝶形花冠的上方通常最大的花瓣，如豌豆和香豌豆。	The upper and usually largest petal of a papilionaceous flower, as in peas and sweet peas.
花被片	Tepal	无花萼和花冠之分的花被裂片。	A segment of a perianth which is not differentiated into calyx and corolla.
喉	Throat	合花冠或合生萼的开口，图 1792；冠筒与冠檐之间花冠的宽展部分。图 1793。	The orifice of a gamoptelous corolla or gamosepalous calyx; the expanded portion of the corolla between the limb and the tube.
旗瓣	Vexillum	如蝶形花冠上方通常最大的花瓣豌豆和香豌豆；旗瓣。	The upper and usually largest petal of a papilionaceous flower, as in peas and sweet peas; banner.
翼瓣	Wing	蝶形花冠两侧的花瓣。	One of the two lateral petals of a papilionaceous corolla.
无花被的	Achlamydeous	花被缺失。	Lacking a perianth.
无花瓣的	Apetalous	花瓣缺失。	Without petals.
离瓣的	Apopetalous	花瓣分离。	With separate petals.
离萼片的	Aposepalous	萼片分离。	With separate sepals.
无花萼的	Asepalous	萼片缺失。	Without sepals.
具双瓣的	Bipetalous	花瓣两枚。	With two petals.
副萼的	Calyculate	具环绕花萼的小苞片，如同外层的花萼。	With small bracts around the clayx, as if possessing an outer calyx.
单被的	Chlamydeous	具一轮花被。	With a floral whorl.
离瓣的	Choripetalous	花瓣分离	With separate petals.
两被的	Dichlamydeous	具两轮不同类型的花被，即花萼和花冠。	With two types of perianth whorls, I.e., calyx and corolla.
两瓣的	Dipetalous	花瓣两枚。	With two petals.
重瓣的	Double	花瓣数目较通常多出许多	Having a larger number of petals than usual.
无冠毛的	Epappose	冠毛缺失。	Without a pappus.
合瓣的	Gamopetalous	具联合或至少部分联合的花瓣。	With the petals united, at least partially.
合萼的	Gamosepalous	萼片联合。	With the sepals united. 
单被的	Monochlamydeous	仅具花被组分的一种。	With only one type of perianth member.
合瓣的	Monopetalous	具联合或至少部分联合的花瓣。	With the petals united, at least partially.
八瓣的	Octopetalous	具八枚花瓣。	With eight petals.
八萼的	Octosepalous	具八枚萼片。	With eight sepals.
具冠毛的	Pappiferous	有冠毛。	Pappose-bearing.
具冠毛的	Pappose	有冠毛。	Pappose-bearing.
具花瓣的	Petaliferous	有花瓣。	Bearing petals.
具花瓣的	Petalous	有花瓣。	With petals.
离瓣的	Polypetalous	具有由完全分离的花瓣组成的花冠。	With a corolla of completely separate petals.
离萼的	Polysepalous	具由分离的萼片组成的花萼。	With a calyx of separate sepals.
合瓣的	Sympetalous	花瓣联合，花瓣至少在近基部联合。	With the petals united, at least near the base.
合萼的	Synsepalous	萼片合生。	With united sepals.
四瓣的	Tetrapetalous	具有四枚花瓣。	With four petals.
三瓣的	Tripetalous	具有三瓣枚瓣。	With three petals.
单瓣的	Unipetalous	仅具有一枚花瓣。	With only a single petal.
渐增的，花后膨大的	Accrescent	逐渐增大，如花期后花萼继续增大。	Becoming larger with age, as a calyx which continues to enlarge after anthesis.
具翅的	Alate	有翅。	Winged。
膨大的	Ampliate	增大或扩展。	Enlarged or expanded.
二唇形的	Bilabiate	具二唇，见于许多不整齐花中。	Two-lipped, as in many irregular flowers.
具距的	Calcarate	具有距；有距的。	With a calcar; spurred.
鞋状的	Calceolate	鞋状或拖鞋状，如某些兰花的唇瓣。	Shoe-shaped or slipper-shaped, as the labellum of some orchids.
钟状的	Campanulate	钟形。	Bell-shaped.
具龙骨状隆起的	Carinate	龙骨状的。	Keeled.
具小角状突起的	Corniculate	具有小的角状突起物	With small horn-like protuberances.
具角状突起的	Cornute	具角。	Horned. See illustration for coniculate.
冕形冠状的	Coroniform	冠形。	Crown-shaped.
十字型的	Cruciate	十字交叉形的。	Cross-shaped
十字型的	Cruciform	十字交叉形的。	Cross-shaped
兜状的	Cucullate	有罩盖或兜帽形。	Hooded or hood-shaped.
平展的	Explanate	平向外展。	Spread out flat.
漏斗状的	Funnelform	自基部向端部逐渐变宽；型像漏斗。	Gradually widening from base to apex; funnel-shaped.
盔状的	Galeate	头盔形；具有盔瓣。	Helmet-shaped; with a galea.
盔状的	Galeiform	头盔形；具有盔瓣。	Helmet-shaped; with a galea.
浅囊状的	Gibbous	单侧鼓起或增大；一面鼓的。	Swollen or enlarged on one side; ventricose.
膨大的	Inflated	鼓起或膨胀；膀胱状的。	Swollen or expanded; bladdery.
漏斗状的	Infundibuliform	漏斗形。	Funnel-shaped. See illustration for funnelform.
雄蕊束	Phalange	由花丝联合在一起的两枚或多枚雄蕊。	Two or more stamens joined by their filaments.
雄蕊束	Phalanx	由花丝联合在一起的两枚或多枚雄蕊。	Two or more stamens joined by their filaments.
花粉	Pollen	由裸子植物的小孢子囊或被子植物的花粉产生的成熟小孢子或正在发育的雄配子体。	The mature microspore or developing male gametophyte of a seed plant, produced in the microsporangium of a gymnosperm or in the anther of an angiosperm.
花粉块	Pollinium (pl. pollinia)	在许多兰科和萝藦科植物中，作为传粉单位的蜡质花粉粒团。	A mass of waxy pollen grains transported as a unit in many members of the Orchidaceae and Asclepiadaceae.
囊	Sac	袋状小室，如花药室。	A bag-shaped-compartment, as the cavity of an anther.
花丝	Stalk	雄蕊中支撑花药的柄。	The stalk of the stamen which supports the anther.
雄蕊	Stamen （pl. stamens，stamina）	花的雄性生殖器官，由花药和花丝组成。	The male reproductive organ of a flower, consisting of an anther and filament.
退化雄蕊	Staminode（pl. staminodia）	不育的、不产生花粉的变态雄蕊。	A modified stamen which is sterile, producing no pollen.
退化雄蕊	Staminodium	不育的、不产生花粉的变态雄蕊。	A modified stamen which is sterile, producing no pollen.
缝	Suture	花药的开裂线。	The line of dehiscence of an anther.
①囊②室	Theca（pl. thecae）	花粉囊或花药室。	A pollen sac or cell of the anther.
载粉器	Translator	萝藦科植物相邻花药的花粉块之间的连接结构。	The connecting structure between the pollinia of adjacent anthers in the Asclepiacaceae.
败育的	Abortive	发育不充分或不正常的；不发育的。	Not fully or properly developed; rudimentary.
能育的	Fertile	能产生种子；能产生花粉。	Capable of bearing seeds; capable of bearing pollen.
显花丝和花药的	Filantherous	雄蕊具有明显花丝和花药。	Of a stamen with a distinct anther and filament.
不育的	Infertile	不育或不能生存。	Sterile or inviable.
瓣状雄蕊的	Petalantherous	具瓣状花丝的雄蕊。	Of a stamen with a petaloid filament.
瓣状的	Petaloid	外形花瓣状。	Petal-like in appearance.
具花粉的	Polliniferous	有花粉。	Bearing pollen.
不发育的	Rudimentary	发育不全的；退化的。	Imperfectly developed; vestigial.
不育的	Sterile	不育，如不产生花粉的雄蕊。	Infertile, as a stamen that does not bear pollen.
偏心的	Eccentric	偏离中心；不位于中轴上。	Off-center; not positioned directly on the central axis.
具柄的	Stipitate	着生在柄或梗上。	Borne on a stipe or stalk.
心皮有柱无柄的	Stylocarpellous	具花柱，但子房与花托之间无柄。	With a style, but without a stipe.
心皮有柱有柄的	Stylocarpepodic	具花柱及连接子房与花托的柄。	With a style and a stipe.
无心皮的	Acarpous	没有心皮。	Without carpels.
双心皮的	Bicarpellate	具两个心皮。	With two carpels.
具两心皮的	Dicarpellate	具两个心皮。	With two carpels.
具二离心皮的	Digynous	具两枚雌蕊。	With two pistils.
具单心皮的	Monocarpous	具一个心皮。	With one carpel.
皮层	Cortex	根表皮和中柱之间的。	Root tissue between the epidermis and the stele.
分生组织	Meristem	位于苗端和根端生长点的未分化、有活跃分裂能力的组织。	Undifferentiated, actively dividing tissues at the growing tips of shoots and roots.
髓	Pith	某些根中央的海绵状薄壁组织。	The spongy，parenchymatous central tissue in some roots.
细根	Rootlet	小根。	A small root.
中柱	Stele	根的初生维管结构。	The primary vascular structure of a root.
根瘤	Tubercule	根瘤，如某些豆科植物根上的瘤。	A nodule, as on the roots of some legumes.
纺锤形	Fusiform	形如纺锤状的，中部最宽，两端渐细。	Spindle-shaped; broadest near the middle and tapering toward both ends.
芜菁状的	Napiform	芜菁根状的。	Turnip-shaped.
芜菁状的	Rapiformis	芜菁根状的。	Turnip-shaped.
纺锤形的	Spindle-shaped	形如纺锤状的，中部最宽，两端渐细。	Spindle-shaped; broadest near the middle and tapering toward both ends.
陀螺状的	Turbinate	陀螺状的。	Top-shaped.
不定的	Adventitious	在非正常位置上发育出的结构或器官，如茎上长出的根。	Structures or organs developing in an unusual position, as roots originating on the stem.
气生的	Aerial	地面或水面之上发生的。	Occurring above ground or water.
板根的	Buttressed	用于支柱或支撑，如某些树的板状树干。	With props or supports, as in the flared trunks of some trees.
须根	Fibrous roots	由粗细相近无主次之分的根组成的根系，如禾草和其它单子叶植物的根。	A root system with all of the branches of approximately equal thickness,  as the grasses and other monocots.
吸器	Haustorium (pl. Haustoria)	寄生植物从寄主吸收营养物质的特化根状器官。	A specialized root-like organ used by parasitic plants to draw nourishment from host plants.
支柱根	Prop root	由下部茎节发出的、支撑茎的不定根。	Adventitious roots arising from lower nodes and providing support to a stem.
生根的	Radicant	匍匐茎节上生出的根。	A root arising from the node of a prostrate stem.
假根	Rhizoid	无输导组织（木质部和韧皮部）的根状结构。	A root-like structure lacking conductive tissues (xylem and phloem).
细根	Rootlet	小根。	A small root.
蕨根茎	Surculum	蕨类的根状茎。	A fern rhizome.
直根	Taproot	具有侧根的主根轴；由主根和侧根组成的根系，见于大多数双子叶植物。	The main root axis from which smaller root branches arise; a root system with a main root axis and smaller branches, as in most dicots.
块状根	Tuberoid	与块茎相似的加厚的根。	A thickened root which resembles a tuber.
根瘤	Tubercule	根瘤，如某些豆科植物根上的瘤。	A nodule, as on the roots of some legumes.
树皮	Bark	木质茎的最外层，包括形成层以外全部活的和死的组织。	The outermost layers of a woody stem including all of the living and nonliving tissues external to the cambium.
树干	Bole	树的分枝以下的主茎。	The main stem of a tree below the branches.
小枝	Branchlet	小的分枝。	A small branch.
芽	Bud	未发育的枝或花。	An undeveloped shoot or flower.
维管束痕	Bundle scar	叶脱落时维管束遗留在枝上的巴痕。	Scar left on a twig by the vascular bundles when a leaf falls.
形成层	Cambium	一种具有强烈分生能力的组织，向内产生木质部，向外产生韧皮部；一种侧生分生组织。	A tissue composed of cells capable of active cell division, producing xylem to the inside of the plant and phleom to the outside; a lateral meristem.
果皮	Pericarp	果实的壁 。	The wall of the fruit.
果核	Pit	核果的石质内果皮，如桃和樱桃。	The stony endocarp of a drupe, as in a peach or cherry.
胎座框	Replum	十字花科短角果或长角果中一室两心皮（假二室）之间的隔膜。	Partition or septum between the two valves or compartments of silicles or siliques in the Cruciferae (Brassicaceae).
种子	Seed	成熟的胚珠。	A ripened ovule.
果瓣	Segment	果实的一部分。	A section of a fruit
隔膜	Septum（pl. Septa）	隔，如子房室之间的隔。	A partition, as the partitions separating the locules of an ovary.
柄	Stipe	连接果实到花托的柄。	A stalk attaching the fruit to the receptacle.
核	Stone	核果中包裹种子的木质、坚硬内果皮。	The hard, woody endocarp enclosing the seed of a drupe.
(花)柱基	Stylopodium	伞形科植物花柱基部的盘状膨大。	A disk like expansion or enlargement at the base of the style on the Umbelliferae (Apiaceae).
缝	Suture	结合线；果实的开裂线。	A line of fusion;
瓣	Valve	裂果的一个果瓣片，成熟时与其它果瓣片分离。	One of the segments of a dehiscent fruit, separating from other such segments at maturity.
油道	Vitta（pl. vittae）	伞形科植物果实心皮壁上的油管。	An oil tube in the carpel walls of the fruits of the Umbelliferae (Apiaceae).
附果	Accessory fruit	由多汁花托而不是由雌蕊发育成的肉质果实。成熟子房为花托表面的小瘦果，如草莓。	A fleshy fruit developing from a succulent receptacle rather than the pistil. The ripened ovaries are small achenes on the surface of the receptacle, as in the strawberry.
瘦果	Achene	单室、单种子的不开裂小干果，种子仅在一点与子房壁相连，如向日葵。	A small, dry, indehiscent fruit with a single locule and a single seed, and with the seed attached to the ovary wall at a single point, as in the sunflower.
槲果	Acorn	橡树类植物不开裂的坚硬干果，具单枚大的种子和杯状基部。	The hard, dry, indehiscent fruit of oaks, with a single, large seed and a cuplike base.
聚合果	Aggregate fruit	通常指由单花的许多离生雌蕊形成的一簇或一组小型肉质果，如悬钩子的簇生小坚果。	Usually applied to a cluster or group of small fleshy fruits originating from a number of separate pistils in a single flower, as in the clustered drupelets of the raspberry.
瘦果	Akene	单室、单种子的不开裂小干果，种子仅在一点与子房壁相连，如向日葵。	A small, dry, indehiscent fruit with a single locule and a single seed, and with the seed attached to the ovary wall at a single point, as in the sunflower.
掺花果	Anthocarp	除果皮外，还有花的某些部分共同参与形成的果实。	A fruit with some portion of the flower besides the pericarp persisting.
假种皮	Aril	种皮的肉质加厚，形似真正的果实，如红豆杉属植物。	A fleshy thickening of the seed coat which resembles a true fruit, as in Taxus.
浆果	Berry	由单枚雌蕊发育成的肉质果实，具有几个或多个种子，如番茄；有时也泛指通体肉质或多汁的果实，即无果核。	A fleshy fruit developing from a single pistil, with several or many seeds, as the tomato. Sometimes applied to any fruit which is fleshy or pulpy throughout, I.e. lacking a pit or core.
刺果	Bur(or burr.)	常具钩、倒刺或附属物的果实。	A fruit armed with often hooked or barbed spines or appendages.
蒴果	Capsule	由两个或多个心皮形成的开裂干果。	A dry, dehiscent fruit composed of more than one carpel.
颖果	Cariopsis	种皮和果皮愈合，具一枚种子的不开裂干果，如禾本科植物的果实； 谷粒。	A dry, one-seeded, indehiscent fruit with the seed coat fused to the pericarp, as in the fruits of the grass family; a grain.
颖果	Caryopsis	种皮和果皮愈合，具一枚种子的不开裂干果，如禾本科植物的果实； 谷粒。	A dry, one-seeded, indehiscent fruit with the seed coat fused to the pericarp, as in the fruits of the grass family; a grain.
周裂蒴果	Circumscissile capsule	沿横向环线开裂的蒴果，其顶部分离呈盖状。	A capsule dehiscing along a transverse circular line, so that the top separates like a lid.
分果	Cremocarp	不开裂的干果，成熟时分开成为数个含一个种子的果瓣（心皮）	A dry, indehiscent fruit which splits into separate one-seeded segments (carpels) at maturity.
核果	Drupe	不开裂的肉质果实，通常具单个种子并由石质内果皮包围，如桃子或樱桃。	A fleshy, indehiscent fruit with a stony endocarp surrounding a usually single seed as in a peach or cherry.
小核果	Drupelet	小的核果，如悬钩子果实中的单个果。	A small drupe, as in the individual segments of a raspberry fruit.
蓇葖果	Follicle	由单个心皮形成的沿一侧开裂的干果，如马利筋。	A dry, dehiscent fruit composed of a single carpel and opening along a single side, as a milkweed pod.
种子状结构，颖果	Grain	类似种子的结构，如酸膜属 的果实； 颖果。	A seed-like structure, as in the fruit of some Rumex species; a caryopsis.
离生的	Distinct	分离；不与相似的部分相连。	Separate;not attached to like parts. (compare connate).
花冠上着生的	Epipetalous	着生在花瓣上。	Attached to the petals.
分离的	Free	不与其它器官相连。	Not attached to other organs.
雌雄蕊合体的	Gynandrous	雄蕊贴生于雌蕊上。	With the stamens adnate to the pistil.
雌雄蕊合体的	Gynostemial	雄蕊贴生于雌蕊上。	With the stamens adnate to the pistil.
单体雄蕊的	Monadelphous	雄蕊的花丝联合，形成围绕雌蕊群的管。	Stamens united by the filaments and forming a tube around the gynoecium.
雄蕊附着花冠的	Petalostemonous	雄蕊花丝与花冠结合，花药与花冠分离。	With the staminal filaments fused to the corolla and the anthers free.
多体的	Polyadelphous	分离成几束着生，如某些花的雄蕊。	Borne in several distinct groups, as the stamens of some flowers.
聚药的	Synandrous	具联合的花药。	With united anthers.
聚药的	Syngenesious	具花药联合的雄蕊。	With stamens united by their anthers.
基着的	Basifixed	花药以基部着生。	With the anther attached by the base.
背着的	Dorsifixed	花药背部着生。	With the anther attached at the back.
丁字着的	Versatile	花药以近中部而非端部着生。	With the anther attached near the middle rather that at one end.
纵裂的	Longitudinal	沿着花药长轴开裂。	Dehiscing along the long axis of the anther.
孔裂的	Poricidal	通过一个孔开裂。	Dehiscing through a pore.
横裂的	Transverse	沿着与花药长轴成直角的方向开裂。	Dehiscing at a right angle to the long axis of the anther.
瓣裂的	Valvular	通过瓣下的小孔开裂。	Dehiscing through flap-covered pores.
雌雄蕊柄	Androgynophore	某些花中着生雄蕊和雌蕊的柄。	Stalk supporting the androecrium and gynoecium in some flowers.
心皮	Carpel	组成单雌蕊或复合雌蕊的变态叶。	A simple pistil formed from one modified leaf, or that part of a compound pistil formed from one modified leaf.
果柄	Carpopodium	着生子房的柄。	A stipe supporting an ovary.
室	Cell	子房中的空腔或室；小室。	A hollow cavity or compartment within an ovary; a locule.
合点	Chalaza	胚珠或种子中珠被和珠心联合的部位，与珠孔相对。	The part of an ovule or seed where the integuments are connected to the nucellus, at the opposite end from the micropyle.
隔膜	Dissepiment	隔，如子房室中的隔。	A partition, as the partitions separation the locules of an ovary.
胚囊	Embryo sac	有花植物胚珠内的雌配子体。	The megagametophyte within the ovule of a flowering plant.
珠柄	Funicle	连接胚珠与胎座的柄；种子的柄。	The stalk connecting the ovule to the placenta; the stalk of a seed.
合蕊柱	Gynandrium	着生雄蕊和雌蕊的柱状结构	A column bearing stamens and pistils.
雌蕊基	Gynobase	花托的伸长或膨大，如紫草科的花。	An elongation or enlargement of the receptacle, as in the flowers of the Boraginaceae.
雌蕊柄	Gynophore	某些花中着生雌蕊的伸长的柄。	An elongated stalk bearing the pistil in some flowers.
珠被	Integument	胚珠的被层，将来发育成种皮。	The covering of the ovule which will become the seed coat.
侵入	Intrusion	向内突入，如胎座突入子房室。	Protrusion into, as placentae into the cell of an ovary.
具单雌蕊的	Monogynous	具一个心皮。	With one carpel.
八雌蕊的，八花柱的	Octogynous	具八个雌蕊或花柱。	With eight pistils or styles.
多心皮的	Polycarpous	具多个心皮。	With many carpels.
多雌蕊的，多花柱的	Polygynous	具多个雌蕊或花柱。	With many pistils or styles.
假单基数的	Pseudomonomerous	实由离生结构愈合而成却看似单一的结构，如看似单心皮的雌蕊，实为两个或多个心皮组成。	A structure which appears to be simple, though actually derived from the fusion of separate structures, as a pistil which appears to be composed of a single carpel, though actually composed of two or more carpels.
单心皮的	Stylodious	具单单个离生的心皮。	With a single, free carpel.
三心皮的	Tricarpellary	具三个心皮。	With three carpels.
单心皮的	Unicarpellous	具单单个离生的心皮。	With a single, free carpel.
离心皮的	Apocarpous	花中的心皮形成离生的雌蕊，如毛茛科植物。	A flower with carpels forming separate pistils, as in a buttercup. (compare Syncarpous).
复[合]子房	Compound  ovary	由两个或多个心皮组成的子房。	An ovary ovary of two or more carpels.
分离的	Free	不与其它器官相连	Not attached to other organs.
雌雄蕊合体的	Gynandrial	雄蕊贴生在雌蕊上。	With the stamens adnate to the pistil.
雌雄蕊合体的	Gynandrous	雄蕊贴生在雌蕊上。	With the stamens adnate to the pistil.
雌雄蕊合体的	Gynostemial	雄蕊贴生在雌蕊上。	With the stamens adnate to the pistil.
半离心皮的	Semicarpous	具心皮部分地结合，花柱和柱头分离的子房。	With ovaries of carpels partly fused, the styles and stigmas separate.
单子房	Simple ovary	子房只由一个心皮构成	An ovary composed of only one carpel.
合心皮的	Syncarpous	具联合的心皮。	With united carpels. (compare apocarpous).
半下位的	Half-inferior	在下半部分着生，如具托杯的花，托杯与子房的下半部分合生，其它花轮看似由子房的近中部发出。	Attached below the lower half, as a flower with a hypanthium that is fused to the lower half of the ovary, giving the appearance that the other floral whorls are arising from about the middle of the ovary.
下位的	Inferior	在下面着生，如着生在其它花轮着生点以下的子房，这些花轮看似由子房顶部发出。	Attached beneath, as an ovary that is attached beneath the point of attachment of the other floral whorls which appear, therefore, to arise from the top of the ovary.
无雄蕊的	Anandrous	没有雄蕊；无雄蕊群。	Without stamens; lacking an androecium.
无雄蕊的	Astemonous	没有雄蕊。	Without stamens.
两雄蕊的	Diandrous	具有两枚雄蕊。	With two stamens.
单轮雄蕊的	Haplostemonous	雄蕊与花瓣数目相同。	With as many stamens as petals.
单雄蕊的	Monandrous	具有单枚雄蕊。	With a single stamen.
八雄蕊的	Octandrous	具有八枚雄蕊。	With eight stamens.
八雄蕊的	Octostemonous	具有八枚雄蕊。	With eight stamens.
少雄蕊的	Oligandrous	具少数几枚雄蕊。	With few stamens.
五雄蕊的	Pentandrous	具有五枚雄蕊。	With five stamens.
多雄蕊的	Polyandrous	具有多枚雄蕊（通常多于十）。	With many stamens (usually more than ten).
多雄蕊的	Polystemonous	具有多枚雄蕊。	With many stamens.
互生的	Alternate	雄蕊生于花瓣之间。 （对比 对生的)。	Stamens borne between the  petals. (compare opposite).
对瓣的	Antepetalous	(雄蕊)正对着花瓣着生。	Directly in front of (opposite) the petals.
对萼的	Antesepalous	(雄蕊) 正对着萼片着生。	Directly in front of (opposite) the sepals.
对瓣的	Antipetalous	(雄蕊)正对着花瓣着生。	Directly in front of (opposite) the petals.
对萼的	Antesepalous	(雄蕊) 正对着萼片着生	Directly in front of (opposite) the sepals.
二强雄蕊的	Didynamous	具有两对不等长的雄蕊；成对出现的。	With two pairs of stamens of unequal length; occurring in pairs.
具外轮对萼雄蕊的	Diplostemonous	具有两轮雄蕊，外轮对着萼片，内轮对着花瓣；雄蕊数是花瓣数的二倍。	With two series of stamens, the outer series opposite the sepals and the inner series opposite the petals; with twice as many stamens as petals.
外曲的	Excurved	离轴 ，向外弯曲	Curing outward, away from the axis.
突出的	Exserted	雄蕊突出于花冠。	Stamens protruding from the corolla.
外向的	Extrorse	离轴，朝向外侧。	Turned outward, away from the axis. (compare introse)
具单轮雄蕊的	Haplostemonous	具一轮雄蕊。	With one series of stamens.
内藏的	Included	雄蕊不伸出花冠。	Stamens not projecting beyond the corolla.
内弯的	Incurved	向内弯曲，朝向轴面	Curving inward, toward the axis.
内向的	Introrse	向轴，朝向内侧。	Turned inward, toward the axis. (compare extrorse)
具外轮对瓣雄蕊的	Obdiplostemonous	具有两轮雄蕊，外轮对着花瓣，内轮对着萼片。	Having two whorls of stamens, the outer whorl opposite the petals and the inner whorl opposite the sepals.
对生的	Opposite	雄蕊与花瓣着生在同一半径轴上。	Stamens borne on the same radius as the petals. (compare alternate)
显雄蕊的	Phaenantherous	具伸出花冠的雄蕊。	With stamens exserted from the corolla.
多体的	Polyadelphous	具有几束离生的雄蕊。	Borne in several distinct groups. (compare monadelphous and diadelphous) .
四强雄蕊的	Tetradynamous	具有四枚长雄蕊和两枚短雄蕊，如大多数十字花科植物。	Having four long and two short stamens, as in most of the Curcifeae (Brassicaceae)
三强雄蕊的	Tridynamous	具两束雄蕊，每束三枚。	With stamens arranged in two groups of three.
附着的	Adherent	不同的部分粘附在一起，如花药粘附于花柱上。结合程度不如贴生的（adnate）牢固。	Sticking together of unlike parts, as the anthers to the style. The attachment is not as firm or solid as adnate.
贴生的	Adnate	不同的部分结合在一起，如雄蕊贴生于花冠上。	Fusion of unlike parts, as the stamens to the corolla. (compare connate)
离生雄蕊的	Apostemonous	具离生的雄蕊。	With separate stamens.
贴伏的	Appressed	紧压或平靠另一器官。	Pressed close or flat against another organ.
紧靠的	Approximate	紧密生长在一起，但并不结合。	Borne close together, but not fused.
愈合的	Coalescent	联合在一起形成一个单位	United together to form a single unit.
连着的	Coherent	相似的部分粘在一起。其结合程度不如合生的（connate）牢固。	Sticking together of like parts. The attachment is not as firm or solid as connate.
合生的	Connate	相似部分的结合，如雄蕊的花丝合生成筒。	Fusion of like parts, as the fusion of staminal filaments into a tube. (compare adnate).
靠合的	Connivent	聚合 ，但并非真正结合或联合。	Converging, but not actually fused or united.
二体雄蕊的	Diadelphous	雄蕊由花丝联合成通常数目不等的两束	Stamens united into two, often unequal, sets by their filaments.
柑果	Hesperidium	具坚韧果皮的浆果状肉质果实，如柠檬或柑橘。	A fleshy berry-like fruit with a tough rind, as a lemon or orange.
蔷薇果	Hip	由膨大的托杯包围多数瘦果形成的 浆果状结构。	A berry-like structure composed of an enlarged hypanthium surrounding numerous achenes.
荚果	Legume	由单个心皮形成的通常沿两条缝开裂的干果，如豆荚。	A dry, dehiscent fruit derived from a single carpel and usually opening along two lines of dehiscence, as a pea pod.
室背开裂蒴果	Loculicidal capsule	沿果室而不是沿隔膜开裂的蒴果（对比室间开裂和孔裂的）。	A capsule dehiscing through the locules of a fruit rather than through the septa. (compare septicidal and poricidal).
节荚	Loment	在种子之间缢缩的荚果	A legume which is constricted between the seeds.
节荚	Lomentum（pl. lomenta）	在种子之间缢缩的荚果。	A legume which is constricted between the seeds.
复果，聚花果	Multiple fruit	由聚集在单个花轴上的几个分离花形成的果实，如桑葚和菠萝。	A fruit formed from several separate flowers crowded on a single axis, as a mulberry or pineapple.
坚果	Nut	不开裂的，通常具单个种子的坚硬干果。	A hard, dry, indehiscent fruit, usually with a single seed.
小坚果	Nutlet	小的坚果；某些紫草科、马鞭草科和唇形科植物成熟子房的裂瓣之一。	A small nut; one of the lobes or sections of the mature ovary of some members of the Boraginaceae, Verbenaceae, and Labiatae (Lamiaceae).
瓠果	Pepo	具坚韧果皮和多数种子的不开裂肉质果实，如甜瓜或黄瓜。	A fleshy, indehiscent, many-seeded fruit with a tough rind, as a melon or a cucumber.
荚[果]	Pod	任何开裂的干果，尤指荚果或蓇葖果。	Any dry, dehiscent fruit, especially a legume or follicle.
梨果	Pome	由下位复合子房形成的不开裂肉质果实，由围绕果核的变态花筒组成，如苹果。	A fleshy, indehiscent fruit derived from an inferior, compound ovary, consisting of a modified floral tube surrounding a core, as in an apple.
孔裂蒴果	Poricidal capsule	由多个小孔开裂的蒴果，如罂粟。	A capsule opening by pores, as in a poppy.
假果	Pseudocarp	由花托而不是由子房发育成的果实，如梨果。	A fruit which develops from the receptacle rather than the ovary, as in a pome.
盖果	Pyxidium	周裂的蒴果，其顶端呈盖状脱落。	A circumscissile capsule, the top coming off as a lid.
翅果	Samara	具翅的不开裂的干果。	A dry, indehiscent, winged fruit.
分果	Schizocarp	不开裂的干果，成熟时分开成为数个含一个种子的果瓣（心皮）。	A dry, indehiscent fruit which splits into separate one-seeded segments (carpels) at maturity.
室间裂蒴果	Septicidal capsule	沿隔膜和室间开裂的蒴果 。（对比 室背开裂的和孔裂的 ）	A capsule dehiscing through the septa and between the locules. (compare loculicidal and poricidal)
短角果	Silicle	十字花科的一种开裂干果，果长小于二倍果宽，两个心皮瓣片从宿存的胎座和(假)隔膜处(胎座框)分开。	A dry, dehiscent fruit of the Cruciferae (Brassicaceae), typically less than twice as long as wide, with two valves separating from the persistent placentae and septum (replum).
长角果	Silique	十字花科的一种开裂干果，果长大于二倍果宽，两个心皮瓣片从宿存的胎座和(假)隔膜处( 胎座框)分开。	A dry, dehiscent fruit of the Cruciferae (Brassicaceae), typically more than twice as long as wide, with two valves separating from the persistent placentae and septum (replum).
隐头果	Syconium(pl. syconia).	无花果的果实，由具中空内陷花托的整个成熟花序形成，花着生在花托内部。	The fruit of a fig, consisting of an entire repened inflorescence with a hollow, inverted receptacle bearing flowers internally.
合心皮果	Syncarp	复果。	A multiple fruit.
胞果	Utricle	果皮薄，含单个种子，多少呈膀胱状膨胀的小的果实。	A small, thin-walled, one-seeded, more or less bladdery-inflated fruit.
具泡状隆起的	Bullate	表面被覆圆形的泡状突起物。	With rounded, blistery projections covering the surface.
具沟的	Canaliculate	具有纵向的沟或槽。	With longitudinal channels or grooves.
格状的	Cancellate	具有细小、规则呈网状的格。	Latteced with a fine, regular, reticulate pattern.
变灰白的	Canescent	由于被覆短而细的灰色或白色毛呈灰色或白色。	Gray or white in color due to a covering of short, fine gray or white hairs.
具沟的	Channeled	具有一条或多条深的纵沟。	With one or more deep longitudinal grooves.
具缘毛的	Ciliate	边缘具有流苏状毛。	With a marginal fringe of hairs.
具短缘毛的	Ciliolate	边缘具有流苏状小毛。	With a marginal fringe of minute hairs.
灰色的	Cinereous	灰色的；由于被覆短毛而呈灰色。	Ash-colored; grayish due to a covering of short hairs.
革质的	Coriaceous	具有皮革般的质地。	With a leathery texture.
具皱褶的	Corrugated	起皱或折叠成交错的沟和脊。	Wrinkled or folded into alternating furrows and ridges.
具长软毛的	Crinite	具簇生的长而软的毛。	With tufts of long, soft hairs.
①无害的②无刺的	Innocuous	无害；缺乏棘或刺。	Harmless; lacking thorns or spines.
光滑的	Laevigate	有光泽的；发亮的。	Lustrous; shinning.
具绵状毛的	Lanate	具绵状毛；密被长卷毛。	Woolly; densely covered with long tangled hairs.
被绒毛的	Lanuginose	绒毛状的或绵毛状的；具软的绒毛。	Downy or woolly; with soft downy hairs.
被绒毛的	Lanuginous	绒毛状的或绵毛状的；具软的绒毛。	Downy or woolly; with soft downy hairs.
短绵状毛的	Lanulose	细小的绵状毛；小绵毛状。	Diminutive of lanate; minutely woolly.
具鳞片的	Lepidote	被覆小的屑状鳞片。	Covered with small, scurfy scales.
有光泽的	Lucid	明亮的，发亮的。	Luminous. Shining.
有光泽的	Lustrous	发亮的或有光泽的。	Shiny or glossy.
具乳突的	Mammillate	具乳头状突起。	With nipple-like protuberances.
具毡状毛的	Manicate	具有厚的相互交织的柔毛。	With a thick, interwoven pubescence.
粉状的	Mealy	连续被粉；粉状，干而易碎。	With the consistency of meal; powdery. Dry, and crumbly.
粗糙的	Muricate	具小而尖的突起。	Rough with small, sharp projections or points.
微糙的	Muriculate	略粗糙。	Very finely muricate.
具珍珠光泽的	Nacreous	具有珍珠般的光泽；珍珠般的。	With a pearly luster；pearlescent.
有光泽的	Nitid	有光泽的；发亮的。	Lustrous; shining.
具斑[点]的	Notate	具有线斑或点斑。	Marked with lines or spots.
糠秕状的	Paleaceous	糠秕状的；具糠秕状的鳞片。	Chaffy; with chaffy scales.
毡毛状的	Pannose	被覆短而密的毡状绒毛。	Covered with a short, dense, felt-like tomentum.
具[花]柱基的	Stylopodic	具花柱基。	With a stylopodium.
三花柱的	Tristylous	具三个花柱。	With three styles.
中轴胎座式	Axile placentation	胚珠着生在二室或多室子房的中轴上。	Ovules attached to the central axis of an ovary with two or more locules.
基生胎座式	Basal placentation	胚珠着生于单室子房的基部。	Ovules positioned at the base of a single-loculed ovary.
特立中央胎座式	Free-central placentation	胚珠着生在单室子房中央的与子房上部不相连的柱上。	Ovules attached to a free-standing column in the center of a unilocular ovary.
边缘胎座式	Marginal placentation	胚珠着生在单心皮的腹缝线上。	Ovules attached to the juxtaposed margins of a simple pistil.
侧膜胎座式	Parietal placentation	胚珠着生于子房壁上。	Ovules attached to the walls of the ovary.
横生胚珠	Amphitropous ovule	直且半倒置，种脐位于侧面的胚珠。	An ovule which is half-inverted and straight, with the hilum lateral.
倒生胚珠	Anatropous ovule	直且倒置，珠孔紧邻珠柄的胚珠。	An ovule which is inverted and straight with the micropyle situated next to the funiculus.
弯生胚珠	Campylotropous ovule	珠孔邻近珠柄和合点的弯曲的胚珠。	An ovule which is curved so that the micropyle is positioned near the funiculus and the chalaza.
横生胚珠	Hemianatropous ovule	珠柄与胚珠长轴成直角的半倒置胚珠。	An ovule which is half-inverted so that the funiculus is attached near the middle with the micropyle at a right angle.
横生胚珠	Hemitropous ovule	珠柄与胚珠长轴成直角的半倒置胚珠。	An ovule which is half-inverted so that the funiculus is attached near the middle with the micropyle at a right angle.
直生胚珠	Orthotropous ovule	竖直的胚珠	An ovule ovule which is straight and erect.
节	Article	果实上相邻缢缩之间的部分。	Section of a fruit separated from others by a constricted joint.
果瓣柄	Carpophore	花托在两个心皮间的细长延伸，作为中轴，如某些伞形科和牻 牛儿苗科植物的果实。	A slender prolongation of the receptacle between the carpels as a central axis, as in the fruits of some members of  the Umbelliferae (Apiaceae) and the Geraniaceae.
室	Cell	子房中包含胚珠的空腔或小室；小腔。	A hollow cavity or compartment within an ovary containing ovules; a locule.
接着面	Commissure	两个心皮彼此连接的面，如伞形科植物	The face by which two carpels join one another, as in the Umbelliferae (Apiaceae)
壳斗	Cupule	杯状总苞，如槲果。	A cup-shaped involucre, as in an acorn.
隔膜	Dissepiment	如子房室之间的隔。	A partition, as the partitions separating the locules of an ovary.
内果皮	Endocarp	果实中果皮的内层。	The inner layer of the pericarp of a fruit. (compare mesocarp and exocarp).
外果皮	Epicarp	果实中果皮的外层。	The outer layer of the pericarp of a fruit. (compare mesocarp and endocarp)
珠柄	Funiculus （pl. funiculi）	种子的柄。	The stalk of a seed.
雌蕊柄	Gynophore	某些花中着生雌蕊的伸长的柄。	An elongated stalk bearing the pistil in some flowers.
托杯，被丝托	Hypanthium	花轴(花托)的杯状延伸部分，常由花萼、花冠和雄蕊群的基部联合而成，通常包围或包裹着雌蕊。	A cup-shaped extension of the floral axis usually formed from the union of the basal parts of the calyx, corolla, and androecium, commonly surrounding or enclosing the pistils.
子房室	Locule	包含种子的子房室或腔。	The chamber or cavity of an ovary containing the seed.
子房室	Loculus（pl. loculi）	包含种子的子房室或腔。	The chamber or cavity of an ovary containing the seed.
分果爿，悬果爿	Mericarp	分果的一部分；伞形科植物果实的两瓣之一。	A section of a schizocarp; one of the two halves of the fruit in the Umbelliferae (Apiaceae).
中果皮	Mesocarp	果实中果皮的中层。	The middle layer of the pericarp of a fruit. (compare endocarp and exocarp)
盖	Operculum	小的盖，如周裂蒴果的脱落盖 。	A small lid, such as the deciduous cap of a circumscissile capsule.
子房	Ovary	雌蕊膨大的基部，内含胚珠；未成熟的果实。	The expanded basal portion of the pistil that contains the ovules; the immature fruit.
珠心	Kernel	胚珠中紧邻珠被下方并包围雌配子体的部分。	The part of the ovule just beneath the integuments and surrounding the female gamitophyte.
室	Locule	子房中包含胚珠的腔或室。	The chamber or cavity of an ovary containing the ovules.
小室	Loculus (pl. loculi)	子房中包含胚珠的腔或室。	The chamber or cavity of an ovary containing the ovules.
珠孔	Micropyle	胚珠珠被上的开口。	The opening in the integuments of the ovule.
珠心	Nucellus	胚珠中紧邻珠被下方并包围雌配子体的部分。	The part of the ovule just beneath the integuments and surrounding the female gamitophyte.
子房	Ovary	雌蕊膨大的基部，内含胚珠。	The expanded basal portion of the pistil that contains the ovules.
胚珠	Ovule	未成熟的种子；种子植物的大孢子囊及其周围的被层。	An immature seed; the megasporangium and surrounding integuments of a seed plant.
雌蕊	Pistil	花的雌性生殖器官，典型的花由花柱、柱头和子房组成。	The female reproductive organ of a flower, typically consisting of a stigma, style, and ovary.
胎座	Placenta (pl. placentae)	子房中着生胚珠的部分。	The portion of the ovary bearing ovules.
果柄	Podogyne	着生子房的柄。	A stipe supporting an ovary.
小喙; 蕊喙	Rostellum	小的喙；兰科柱头上边缘的一个突起。	A small beak; an extension from the upper edge of the stigma in orchids.
隔膜	Septum (pl. septa)	隔，如子房室中的隔。	A partition, as the partitions separation the locules of an ovary.
柱头	Stigma	雌蕊接受花粉的部位。	The portion of the pistil which is receptive to pollen.
柄，梗	Stipe	支撑某枚结构的柄或梗，如某些花中连接子房与花托的柄。	A stalk supporting a structure, as the stalk attaching the ovary to the receptacle in some flowers.
花柱	Style	雌蕊中连接柱头和子房的通常部分。	The usually narrowed portion of the pistil connecting the stigma to the ovary.
(花)柱基	Stylopodium	伞形科植物花柱盘状膨大基部的结构。	A disk-like expansion or enlargement at the base of the style in the Umbelliferae (Apiaceae).
心皮无柱无柄的	Astylocarpellous	无花柱以及连接子房与花托的柄。	Lacking a style and a stipe.
心皮无柱有柄的	Astylocarpepodic	无花柱，但子房与花托之间有柄。	Without a style, but with a stipe.
无花柱的	Astylous	没有花柱。	Without a style. 
上位的	Superior	在上面着生，如着生在其它花轮着生点以上的子房。	Attached above, as an ovary that is attached above the point of attachment of the other floral whorls.
无花柱的	Astylous	没有花柱。	Without a style.
二深裂的	Bifid	通常从顶部深二裂或二瓣。	Deeply two-cleft or two-lobed, usually from the tip.
偏心的	Eccentric	偏离中心；不位于中轴上。	Off-center. Not positioned directly on the central axis.
基着式花柱	Gynobasic style	既着生于心皮上又着生于雌蕊基上的花柱。	A style which is attached to the gynobase as well as to the carpels.
花柱异长的	Heterostylic	同一种植物的花具有长度不等的花柱。	With styles of different lengths in flowers of the same species.
花柱异长的	Heterostylous	同一种植物的花具有长度不等的花柱。	With styles of different lengths in flowers of the same species.
花柱同长的	Homostylic	同一种植物花的花柱长度基本一致。	With styles of more or less constant length in flowers of the same species.
花柱同长的	Homostylous	同一种植物花的花柱长度基本一致。	With styles of more or less constant length in flowers of the same species.
长花柱的	Macrostylous	具长的花柱。	With a long style.
单花柱的	Monostylous	仅有一个花柱。	With a single style.
灯心草状的	Rush-like	具有不明显的花，形似禾草。	Grass-like in appearance, with inconspicuous flowers.
肉茎的	Sarcocaulous	具有肉质的茎。	With fleshy stems.
肉茎的	Sarcous	多肉的。	Fleshy.
具长匐茎的	Sarmentose	具有细长的纤匍茎。	With long, slender runners.
攀缘的	Scandent	攀缘的。	Climbing.
花葶状的	Scapiform	花形似花葶，但并非完全无叶。	Scape-like but not entirely leafless.
单枝的	Simple	不分枝。	Unbranched.
具根出条的	Soboliferous	根出条的或与根出条相关的；	Of or pertaining to sobols; bearing sobols.
拱垂的	Sprawling	向下弯曲,靠着某物并由其支撑。	Bending or curving downward; lying upon something and being supported by it.
平展的	Spreading	接近于水平伸展,几乎平卧。	Extending nearly to the horizontal; almost prostrate.
具匍匐茎的	Stoloniferous	具有匍匐茎。	Bearing stolons.
匍匐茎状的	Stoloniform	形似匍匐茎的。	Stolon-like.
笔直的	Strict	直，垂直，全然不平展。	Very straight and upright, not at all spreading.
近花葶状的	Subscapose	几近花葶。	Almost scapose.
地下的	Subterranean	位于地面之下。	Below the surface of the ground.
地下的	Subterraneous	位于地面之下。	Below the surface of the ground.
肉质的	Succulent	肉质多汁，如仙人掌的茎。	Juicy and fleshy, as the stem of a cactus.
半灌木状	Suffrutescent	略微灌木状，基部轻度木质化。	Somewhat shrubby; slightly woody at the base.
半灌木的	Suffruticose	轻度木质化。	Somewhat woody.
具中脉的	Costate	具肋纹的。	Ribbed.
网状脉的	Net-veined	网络状或网状的。	In the form of a network; reticulate.
平行脉的	Parallel-veined	主脉平行于叶轴或彼此平行。	With the main veins parallel to the leaf axis or to each other.  (compare net-veined)
羽状掌状的	Pinnipalmate	羽状和掌状之间的中间类型，叶片的第一对脉比其它的脉大而明显。	Intermediate between pinnate and plamate, as in a leaf with the first pair of veins larger and more distinctive than the others.
网状的	Reticulate	呈网络；网状脉。	In the form of a network; net-veined.
具肋的	Ribbed	具明显的肋状突起或脉纹。	With prominent ribs or veins. See illustration for costate.
具三脉的	Trinerved	三脉，都从近基处发出。	Three-nerved, with the nerves all arising from near the base. (compare triplinerved).
离基三出脉的	Triplinerved	三脉，两侧脉从中脉基部的上方分出。	Three-nerved, with the two lateral nerves arising from the midnerve above the base. (compare trinerved)
具脉的	Venose	具脉纹。	Veiny.
具二齿的	Bidentate	具两个齿。	With two teeth.
二裂的	Bifid	通常从顶端深二裂或裂为两个圆裂片。	Deeply two-cleft or two-lobed, usually from the tip.
掌状裂的	Palmatifid	掌状半裂或浅裂。	Palmately cleft or lobed.
掌状全裂的	Palmatisect	掌状全裂。	Palmately divided.
深裂的	Parted	深裂，通常超过至基部或中脉的一半。	Deeply cleft, usually more than half the distance to the base or midvein.
鸟足状的	Pedate	掌状全裂，外侧的裂片二裂。	Palmately divided, with the lateral lobes 2-cleft.
羽状半裂的	Pinnatifid	羽状半裂或浅裂至中脉的一半或更多，但未达到中脉。	Pinnately cleft or lobed half the distance or more to the midrib, but not reaching the midrib.
羽状浅裂的	Pinnatilobate	具羽状排列的浅裂片。	With pinnately arranged lobes.
羽状全裂的	Pinnatisect	羽状裂至中脉。	Pinnately cleft to the midrib.
四回羽状裂的	Quadripinnatifid	四次羽状的分裂。	Four times pinnately cleft.
残波状的	Repand	边缘有些波状或微弱的弯曲。等同波状的（undulate）。	With a slightly wavy or weakly sinuate margin.
外卷的	Revolute	边缘向下后卷（对比内卷的）。	With the margins rolled backward toward the underside. (compare involute)
倒向羽裂的	Runcinate	急羽裂或半裂，裂片向下。	Sharply pinnatifid or cleft, the segments directed downward.
有锯齿的	Serrate	叶缘具齿，尖齿向前。	Toothed along the margin, the sharp teeth pointing forward.
有细锯齿的	Serrulate	缘有细小的尖齿，尖齿向前。	Toothed along the margin with minute, sharp, forward-pointing teeth.
具深波状的	Sinuate	具强烈波状弯曲的边缘。	With a strongly wavy margin.
波状的	Sinuous	波浪或蛇行的形状。	Of a wavy or serpentine form.
三齿的	Tridentate	三齿。	Three-toothed.
三裂的	Trifid	三裂	Three-cleft
三深裂的	Tripartite	三深裂。	Three-parted.
三回羽状半裂的	Tripinnatifid	三次羽状半裂。	Three pinnately cleft.
波状的	Undulate	波浪状，但波曲程度不及深波状（sinuate）。	Wavy, but not so deeply or as pronounced as sinuate.
抱茎的	Amplexicaul	抱茎，如某些叶子的基部或托叶紧抱着茎干。	Clasping the stem, as the base or stipules of some leaves.
耳状抱茎的	Auriculate-clasping	叶基具耳状裂片，环绕着茎干。	Earlike lobes at the base of a leaf, encircling the stem.
抱茎的	Clasping	全部或部分围绕着茎干。	Wholly or partly surrounding the stem.
对生连基抱茎的	Connate-perfoliate	对生叶的基部联合并围绕茎干。	With the bases of opposite leaves fused around the stem.
下延的	Decurrent	从着生点向下延伸，如叶基沿茎干向下延伸。	Extending downward from the point of insertion, as a leaf base that extends down along the stem.
假单花花序	Pseudanthium	由许多小花密集而成，外观像一朵花的花序。	A compact inflorescence of many small flowers which simulates a single flower.
总状花序	Raceme	花具柄，由基向上渐次成熟，长而不分枝的花序。	An unbranched, elongated inflorescence with pedicellate flowers maturing from the bottom upwards.
蝎尾状聚伞花序	Scorpioid cyme	花序轴“之”字形弯曲的有限花序。	A determinate cymose inflorescence with a zigzag rachis.
单生花	Solitary	花单朵出现而不是一簇或一群。	Flowers occurring singly and not borne in a cluster or group.
佛焰花序，肉穗花序	Spadix	小花密集生于肥厚的轴上的穗状花序。	A spike with small flowers crowed on a thickened axis.
穗状花序	Spike	花或小穗花具柄，由基向上渐次成熟，长而不分枝的花序。	An unbranched, elongated inflorescence with sessile or subsessile flowers or spikelets maturing from the bottom upwards.
小穗	Spikelet	小型的穗状花序或次级穗状花序；由两片枚片（颖片）包裹的一至多花组成的禾草和莎草的末级花穗。	A small spike or secondary spike; the ultimate flower cluster of grasses and sedges, consisting of one to many flowers subtended by two bracts (glumes).
球穗花序	Strobile	球果或者像球果的花序。	A cone or an inflorescence resembling a cone.
聚伞圆锥花序	Thyrse	主轴无限、侧轴聚伞状，圆柱状或卵形的密集圆锥花序。	A compact, cylindrical, or ovate panicle with an indeterminate main axis and cymose subaxes.
伞形花序	Umbel	平顶或凸顶，花梗伞撑状、小花梗从同一点分出呈伞辐状的花序，高度密集的总状花序。	A flat-topped or convex inflorescence with the pedicels arising more or less from a common point, like the struts of an umbrella; a highly condensed raceme.
小伞	Umbellet	复伞形花序的末级伞状簇。	An ultimate umbellate cluster of a compound umbel.
轮状聚伞花序	Verticillaster	从对生叶或苞片腋部伸出的假轮生的聚伞花序。	A pair of axillary cymes arising from opposite leaves or bracts and forming a false whorl.
雄雌同序的	Androgynous	同时具有雄花和雌花的花序，雄花着生部位高于雌花，如苔草属的某些种。	An inflorescence with both staminate and pistillate flowers, the staminate flowers borne above the pistillate, as in some Carex species. (compare gynaecandrous)
腋生的	Axillary	着生于或发自腋部。	Positioned in or arising in an axil.
头状的	Capitate	头状或呈头状成簇，如菊科的花。	Head-like, or in a head-shaped cluster, as the flower in the Compositae (Asteraceae).
小头状的	Capitellate	具小的头状结构或多个非常小的头形簇。	With small head-like structures, or with parts in very small head-shaped clusters.
离心花序	Centrifugal inflorescence	自中心向外开放的花簇，如聚伞花序。	A flower cluster developing from the center outward, as in a cyme.
向心花序	Centripetal inflorescence	自边缘向中心开放的花簇，如伞房花序。	A flower cluster developing from the edge toward the center, as in a corymb.
伞房花序状的	Corymbiform	形似伞房花序，但结构不一定是真正的伞房花序。	An inflorescence with the general appearance, but not necessarily the structure, of a true corymb.
伞房状的	Corymbose	花排列成伞房花序。此术语有时等同伞房花序状的。	Having flowers in corymbs. The term sometimes used in the same sense as Corymbiform
杯状的	Cyathiform	具杯状聚伞花序；茶杯状。	With the form of a cyanthium; cup-shaped.
聚伞状	Cymose	花排列成聚伞花序。	With flowers in a cyme.
有限的	Determinate	用来描述端花先开，阻止主轴进一步延伸的花序。	Describes an inflorescence in which the terminal flower blooms first, halting further elongation of the main axis.
团集的	Glomerate	密集成簇。	Densely clustered.
团伞状的	Glomerulate	非常小的、密集成簇排列。	Arranged in very small, dense clusters.
雌雄同序的	Gynaecandrous	雌花着生部位高于雄花的花序，如苔草属的某些种。（对比雄雌同序的）	An inflorescence with the pistillate flowers borne above the staminate, as in some Carex species. (compare androgynous)
螺卷状的	Helicoid	螺旋状卷曲，如紫草科的某些单侧聚伞花序。	Coiled like a spiral or helix, as in some one-sided cymose inflorescences in the Boraginaceae.
无限的	Indeterminate	用来描述基部或外侧花先开放，主轴得以无限延伸的花序。	Describes an inflorescence in which the lower or outer flowers bloom first, allowing indefinite elongation of the main axis.
单歧聚伞状的	Monochasial	具单歧聚伞花序的形式。	With the form of a monochasium.
圆锥状的	Paniculate	花排列成圆锥花序。	Having flowers in panicles.
圆锥花序状的	Paniculiform	形似圆锥花序，但结构不一定是真正圆锥花序。	An inflorescence with the general appearance, but not necessarily the structure, of a true panicle.
总状花序状的	Racemiform	形似总状花序但结构区别于真正总状花序的花序。	An inflorescence with the general appearance, but not necessarily the structure, of a true raceme.
总状的	Racemose	花排列成总状花序。此术语有时和总状的同义。	Having flowers in racemes. The term is sometimes used in the same sense as racemiform.
蝎尾状的	Scorpioid	花序轴“之”字形弯曲的有限聚伞花序。	A determinate cymose inflorescence with a zigzag rachis; often used in the same sense as helicoid.
偏向的	Secund	仅排列在轴的一侧。	Arranged on one side of the axis only.
佛焰苞的	Spathaceous	具佛焰苞；佛焰苞状。	Spathe bearing; spathe-like.
穗状的	Spicate	成穗排列。	Arranged in a spike.
穗状花序状的	Spiciform	形似穗状花序但结构不一定是真正的穗状花序。	An inflorescence with the general appearance, but not necessarily the structure, of a true spike.
顶生的	Terminal	位于在顶端或顶部。	At the tip or apex.
聚伞圆锥状的	Thyrsoid	聚伞圆锥花序状。	Thyrse-like.
伞形的	Umbellate	排列成伞形花序；伞形花序状。	In umbels; umbel-like. 
伞形花序状的	Umbelliform	形似伞形花序，但结构不一定是真正的伞形花序。此术语常密集的聚伞花序而不是密集的总状花序。	An inflorescence with the general appearance, but not necessarily the structure, of a true umbel. The term is often applied to inflorescences which are condensed cymes rather than condensed racemes.
雄蕊群	Androecium	一朵花内所有雄蕊的总称。	All of the stamens in a flower, collectively.
花萼	Calyx (pl. calyces，calyxes)	外轮花被；一朵花内所有萼片的总称。	The outer perianth whorl; collective term for all of the sepals of a flower.
心皮	Carpel	组成单雌蕊或复合雌蕊的变态叶；大孢子叶。	A simple pistil formed from one modified leaf, or that part of a compound pitil formed from one modified leaf; megasporophyll.
花冠	Corolla	一朵花内所有花瓣的总称；内轮花被。	The collective name for all of the petals of a flower; the inner perianth whorl.
花被	Floral envelope	花冠的总称。等同花被。	A collective term for the calyx and corolla. (same as perianth)
雌蕊群	Gynecium	一朵花内所有心皮或雌蕊的总称。	All of the carpels or pistils of a flower, collectively.
雌蕊群	Gynoecium	一朵花内所有心皮或雌蕊的总称。	All of the carpels or pistils of a flower, collectively.
蜜腺	Nectar gland	产生花蜜的组织或器官。	A tissue or organ which produces nectar.
蜜腺	Nectary	产生花蜜的组织或器官。	A tissue or organ which produces nectar.
花梗	Pedicel	花序中单朵花的柄。	The stalk of a single flower in an inflorescence.
花序梗	Peduncle	单生花或花序的柄。	The stalk of a solitary flower or of an inflorescence.
花被	Perianth	花的花萼和花冠的总称，尤指二者外形相似时。	The calyx and corolla of a flower, collectively, especially when they are similar in appearance.
花瓣	Petal	花冠的单个裂片或部分，常有色或白色。	An individual segment or member of the corolla, usually colored or white.
雌蕊	Pistil	花的雌性生殖器官，典型地由柱头、花柱和子房组成。	The female reproductive organ of a flower, typically consisting of a stigma, style, and ovary. (compare to gynoecium)
花托	Receptacle	着生花部器官的花梗部分；在菊科中指着生头状花序花的花序梗部分。	The portion of the pedicel upon which the flower parts are borne; in the Compositae (Asteraceae), the part of the peduncle where the flowers of the head are borne.
萼片	Sepal	花萼的裂片。	A segment of the calyx.
雄蕊	Stamen (pl. stamens, stamina)	花的雄性生殖器官，由花药和花丝组成；被子植物的小孢子叶。	The male reproductive organ of a flower, consitsting of an anther and filament; the angiosperm microsporophyll.
花被片	Tepal	无花萼和花冠之分的花被片；萼片或花瓣。	A segment of a perianth which is not differentiated into calyx and corolla; a sepal or petal.
延伸的	Excurrent	超常延伸，如叶基沿茎干下延。	Extending beyond what is typical, as in a leaf base which extends down the stem.
具托叶鞘的	Ocreate	具鞘状托叶。	With sheathing stipules.
茎穿叶的	Perfoliate	叶边缘完全包围绕着茎，使茎看似从叶中穿过。	A leaf with the margins entirely surrounding the stem, so that the stem appears to pass through the leaf.
具叶柄的	Petiolate	叶具柄。	With a petiole.
具叶柄的	Petioled	叶具柄。	With a petiole.
叶基	Base	距叶着生点最近的叶片基部。	The end of the leaf blade nearest to the point of attachment.
叶片	Blade	叶的宽展部分。	The broad part of a leaf.
叶颈	Collar	禾草叶片和叶鞘联接处的外延部分。	The area on the outside of a grass leaf at the juncture blade and sheathe.
中脉	Costa (pl. Costae)	肋或显著的叶中脉。	A rib or prominent midevein of a leaf.
小齿	Denticle	小齿或齿状突出物。	A small tooth or tooth-like projection.
小叶	Leaflet.	复叶上的小叶。	A division of a compound leaf.
叶片	Limb	叶的宽展的部分。	The expanded part of a leaf.
半灌木的	Suffruticulose	轻度木质化。	Somewhat woody.
具根出条的	Surculose	从基部或根状茎上长出根出条或纤匐茎。	Producing suckers or runners from the base or from rootstocks.
地表的	Surficial	在近地面或地面上蔓生的。	Growing near the ground, or spread over the surface of the ground.
四棱的	Tetragonal	有四个棱角	Four-angled.
蔓生的	Trailing	平卧匍匐生长，但不生根。	Prostrate and creeping but not tooting.
三棱的	Triangulate	三个棱角的。	Three-angled.
三棱的	Trigonal	有三个棱。	Three-angled.
三棱的	Trigonous	有三个棱。	Three-angled.
丛生的	Tufted	密集成簇排列。	Arranged in a dense cluster.
缠绕的	Twining	围绕一个支撑物（如另一个茎）螺旋状盘绕支持物（常为其它茎）攀援生长。	Coiling or spiraling around a support (usually another stem ) for climbing.
无刺的	Unarmed	无刺，皮刺或棘刺。	Lacking spines, prickles, or thorns
单轴的	Uniaxial	单一不分枝的茎终止于花。	With a single unbranched stem terminating in a flower.
柔韧枝的	Vimineous	具有长而柔韧的小枝；由小枝组成；小枝状。	With long, flexible twigs; composed of twigs; twig like.
帚状的	Virgate	棒状的；细直，直立。	Wand like; straight, slender, and erect
具翅的	Winged	具有翅。	Possessing wings.
裂片	Lobe	器官的圆裂片，如叶的裂片。	A rounded division or segment of an organ, as of a leaf.
小裂片	Lobule	小裂片；裂片的次级裂片。	A small lobe; a lobe like subdivision of a lobe.
叶缘	Margin	叶片的边缘。	The edge of a leaf blade.
中裂片	Midlobe	叶的中央裂片。	The central lobe of a leaf.
中脉	Midnerve	叶的中央脉。	The central nerve of a leaf.
中脉	Midrib	叶的中脉或中肋。	The central rib or vein of a leaf.
中脉	Midvein	叶的中央叶脉。	The central vein of a leaf.
短尖头	Mucro	短而骤尖的叶端。	A short, sharp, abrupt point, usually at the tip of a leaf.
两浅裂片的	Bilobed	分成两个圆裂片。	Divided into two lobes.
二深裂的	Bipartite	二裂几近叶片的基部。	Divided almost to the base into two divisions.
二回羽状裂的	Bipinnatifid	两次羽状半裂。	Twice pinnately cleft.
二裂的	Bisected	裂成两部分。	Split into two parts.
具重锯齿的	Biserrate	叶缘锯齿上再具小锯齿。	Doubly serrate, as when the teeth of a serrate leaf are also serrate.
半裂的	Cleft	裂至基部或中部的一半。	Cut or split about half-way to the middle or base.
具圆齿的	Crenate	叶缘具圆形的齿。	With rounded teeth along the margin.
具细圆齿的	Crenulate	叶缘具很小的圆齿。	With very small rounded teeth along the margin.
皱波状的	Crisped	弯曲，波状或皱褶状。	Curled, wavy or crinkled.
具齿的	Dentate	叶缘具齿，尖朝外不向前。	Toothed along the margin, the teeth directed outward rather than forward.
具细牙齿的	Denticulate	叶缘具很小的牙齿。	Dentate with very small teeth.
指状的，掌状复出的	Digitate	从一个点上浅裂，具脉或裂片，好象一只手的手指一样。等同掌状的（palmate）。	Lobed, veined, or divided from a common point, like the fingers of a hand.
多裂的	Dissected	深裂为多个狭的裂片。	Deeply divided into many narrow segments.
全裂的	Divided	分或裂至叶基或中脉。	Cut or lobed to，essentially to the base or to the midrib.
无齿的	Edentate	不具齿。	Without teeth.
全缘的	Entire	无齿、缺刻或裂片, 如某些叶的边缘。	Not toothed, notched, or divided, as the continuous margins of some leaves.
啮蚀状的	Erose	叶缘具参差不齐的齿，好象被啃过似的。	With the margin irregularly toothed, as if gnawed.
浅啮蚀状的	Erosulate	多少有些啮蚀状。	More or less erose.
①具缺刻的②锐裂的	Incised	通常参差不齐、急而深的裂。	Cut sharply, deeply, and usually irregularly.
内卷的	Inrolled	向内弯曲或卷曲；内卷。	Curled or rolled inward; involute.
内卷的	Involute	边缘向上内卷。（对比外卷的）。	With the margins rolled inward toward the upper side. (compare revolute)
撕裂状的	Lacerate	不规则的分裂或半裂，好象被撕开似的。	Cut or cleft irregularly, as if torn.
具刺的	Echinate	具皮刺或刺。	With prickles or spines.
具小刺的	Echinulate	具有很小的皮刺或刺。	With very small prickles or spines.
具小平面的	Faceted	具有多个平的表面，象切割的宝石，如某些种子。	With many plane surfaces, like a cut gem, as in some seeds.
被粉的	Farinose	被覆粉状物。	Covered with a mealy, powdery substance.
蜂窝状的	Faveolate	蜂窝状的或具凹痕；多小孔的。	Honeycombed or pitted; alveolate.
蜂窝状的	Favose	蜂窝状的或具凹痕；多小孔的。	Honeycombed or pitted; alveolate.
具窗孔的	Fenestrate	具窗形的穿孔、开口或透明的区域。	With window-like perforations, openings, or translucent areas.
流苏状的	Fimbriate	流苏状的，通常由毛或毛状物沿边缘形成。	Fringed, usually with hairs or hairlike structures (fimbrillae) along the margin.
茎基	Caudex (pl. Caudices. Caudexes)	多年生草本植物宿存的木质化的基部。	The persistent and often woody base of a herbaceous perennial.
幼茎	Caulicle	小的枝，未发育的枝条。	A small stem; a rudimentary stem.
茎	Caulis	草本植物的主茎。	The main stem of a herbaceus plant.
叶状枝	Cladode	具有叶的形状和功能的枝。	A stem with the form and function of a leaf.
叶状枝	Cladophyll	具有叶的形状和功能的枝。	A stem with the form and function of a leaf.
球茎	Corm	短小、实心、直立生长的地下茎，具薄纸质的叶。	A short, solid, vertical underground stem with thin papery leaves.
小球茎	Cormel	大球茎基部生出的小球茎。	A small corm arising at the base of a larger corm.
秆	Culm	中空或具髓的杆或茎，如禾草、莎草、灯心草。	A hollow or pithy stalk or stem, as in the grasses, sedges, and rushes.
生花茎	Floricane	第二年开花结果的枝杆。	The second-year flowering and fruiting cane (shoot) of Rubus. (compare primocane).
藤本植物	Liana	木质化的攀援藤本。	A woody, climbing vine.
单轴	Monopodium (pl. Monopodia)	所有侧枝由单个主轴产生。	A single main axis giving rise to lateral branches.
短匐茎	Offset	由近地面茎分枝的短的匍匐茎。	A short, often prostrate, shoot originating near the ground at the base of another shoot,
分株	Offshoot	从主茎上分出的枝。	A shoot or branch arising form a main stem.
叶状枝	Phylloclade	具有叶的形状和功能的枝。	A stem with the form and function of a leaf.
无花茎	Primocane	第一年生通常无花的枝杆。	The first-year, usually flowerless, cane(shoot) of Rubus. (compare floricane)
假花葶	Pseudoscape	假花葶，并非所有的叶都基生，仅仅是象基生。	A false scape, where not all of the leaves are truly basal in origin though, superficially, they appear to be so.
截根苗	Ratoon	从被砍伐植物的根部长出的苗。	A shoot arising from the root of a plant that has been cut down.
根状茎	Rhizome	横生的地下茎；根状茎。	A horizontal underground stem; rootstock.
纤匐茎	Runner	在节处和茎的先端生根的纤细匍匐茎。	A slender stolon or prostrate stem rooting at the nodes or at the tip.
长匐茎	Sarment	细长的纤匐茎。在节处和茎的先端生根的纤细匍匐茎。	A long, slender runner.
苗	Shoot	幼茎或幼枝。	A young stem or branch.
根出条	Sobol	发自茎基的长枝条；从茎的基部或根状茎上长出的枝条。	Elongated caudex branches; a shoot arising from the base of a stem or from the rhizome.
根出条	Sobole	发自茎基的长枝条；从茎的基部或根状茎上长出的枝条。	Elongated caudex branches; a shoot arising from the base of a stem or from the rhizome.
叶花（果）梢	Spray	具有叶花或果的纤细枝条。	A slender shoot or branch with its leaves, flowers, or fruits.
匍匐茎	Stolon	沿地面横生的长茎，在节处或端部生根，并产生新的植株。	An elongate, horizontal stem creeping along the ground and rooting at the nodes or the tip and giving rise to a new plant. See runner.
根株	Stool	每年生出新茎的植物基部。从单一根上长出的一簇茎。多年生草本植物宿存的木质化的基部。	The base of plants which produce new stems each year. A group of stems arising from a single root.
根出条	Sucker	从地下长出的枝条。	A shoot originating form below ground.
合轴	Sympodium	主轴看似单轴，但实际上由许多短的腋生枝相继发育而成，而不是由单一顶芽延续而成。	A main axis appearing to be simple, but actually consisting of a number of short axillary branches rather than a continuation of the main axis.
刺	Thorn	针状的木质变态茎，有时泛指其它类似的真刺的结构。	A stiff, woody, modified stem with a sharp point; sometimes applied to any structure resembling a true thorn.
分蘖	Tiller	多少直立的基生的或地下的枝条。从地下长出的枝条。	A basal or subterranean shoot which is more or less erect.
